"GeographyCode","QS115EW0001","QS115EW0002","QS115EW0003","QS115EW0004","QS115EW0005","QS115EW0006","QS115EW0007","QS115EW0008","QS115EW0009","QS115EW0010","QS115EW0011","QS115EW0012"
"E00032987",87,26,6,20,61,9,7,7,17,3,3,15
"E00032988",200,142,13,129,58,6,0,6,34,0,3,9
"E00032989",232,174,9,165,58,9,5,9,25,1,2,7
"E00032990",219,148,31,117,71,8,1,11,41,0,1,9
"E00032991",219,154,3,151,65,6,0,5,39,0,3,12
"E00032992",165,123,7,116,42,7,2,5,12,1,2,13
"E00032993",166,87,11,76,79,5,6,8,50,1,3,6
"E00032994",63,36,12,24,27,9,3,3,9,0,1,2
"E00032995",149,82,40,42,67,11,13,5,18,2,5,13
"E00032996",181,63,29,34,118,30,19,15,19,4,6,25
"E00032997",106,44,12,32,62,11,4,13,20,0,2,12
"E00032998",164,63,16,47,101,12,12,18,35,3,3,18
"E00032999",236,153,8,145,83,9,1,3,58,2,2,8
"E00033000",87,41,33,8,46,7,15,4,2,2,3,13
"E00033002",129,74,11,63,55,5,5,7,23,4,4,7
"E00033004",167,102,9,93,65,3,6,6,40,0,2,8
"E00033005",176,85,29,56,91,14,19,7,26,2,8,15
"E00033006",120,32,15,17,88,10,15,10,28,1,5,19
"E00033007",155,72,32,40,83,10,14,12,22,6,3,16
"E00033008",147,54,14,40,93,26,7,11,19,5,11,14
"E00033012",104,66,6,60,38,0,8,4,25,0,0,1
"E00033013",115,61,13,48,54,7,1,9,28,1,2,6
"E00033015",109,41,5,36,68,2,0,10,48,0,0,8
"E00033016",226,128,6,122,98,5,1,19,37,11,10,15
"E00033018",72,36,3,33,36,2,0,1,21,0,0,12
"E00033019",218,145,8,137,73,12,3,4,32,1,3,18
"E00033020",143,94,2,92,49,1,1,2,33,0,1,11
"E00033021",134,65,15,50,69,6,7,10,29,2,5,10
"E00033023",149,86,33,53,63,4,5,9,15,0,3,27
"E00033024",104,58,14,44,46,8,7,4,16,0,1,10
"E00033025",135,56,14,42,79,4,12,16,33,1,5,8
"E00033026",90,28,13,15,62,2,12,20,9,2,3,14
"E00033027",200,109,36,73,91,6,11,10,33,2,1,28
"E00033029",111,39,9,30,72,6,9,12,25,1,1,18
"E00033030",95,23,10,13,72,1,23,12,8,1,7,20
"E00033031",130,39,16,23,91,1,11,20,28,2,6,23
"E00033032",238,154,19,135,84,3,5,8,63,0,0,5
"E00033033",193,122,9,113,71,7,0,8,50,0,0,6
"E00033034",201,118,5,113,83,5,2,7,59,0,0,10
"E00033035",159,57,12,45,102,5,12,10,48,1,4,22
"E00033036",128,75,6,69,53,10,0,5,34,0,0,4
"E00033037",153,78,25,53,75,4,27,12,14,0,5,13
"E00033038",110,73,1,72,37,6,1,3,20,0,1,6
"E00033040",132,69,15,54,63,2,7,13,21,2,2,16
"E00033041",110,33,25,8,77,5,13,17,19,3,7,13
"E00033042",98,27,14,13,71,1,16,8,12,1,10,23
"E00033043",112,28,10,18,84,4,14,17,28,1,4,16
"E00033044",92,18,10,8,74,2,21,12,10,1,4,24
"E00033045",132,81,42,39,51,6,12,8,14,1,3,7
"E00033046",121,73,51,22,48,0,29,2,13,1,0,3
"E00033047",106,19,10,9,87,3,18,18,17,1,8,22
"E00033048",100,23,18,5,77,0,20,15,15,1,8,18
"E00033049",154,41,7,34,113,10,5,31,37,1,7,22
"E00033050",84,13,9,4,71,0,11,11,17,1,8,23
"E00033051",167,65,6,59,102,8,13,6,57,1,1,16
"E00033052",144,41,14,27,103,3,12,12,25,2,6,43
"E00033053",111,32,10,22,79,7,6,15,24,2,3,22
"E00033054",76,30,8,22,46,7,7,4,12,2,4,10
"E00033055",106,35,6,29,71,2,7,15,26,6,3,12
"E00033056",123,34,10,24,89,5,17,25,26,2,2,12
"E00033057",122,39,14,25,83,4,12,27,18,2,5,15
"E00033059",149,63,42,21,86,9,21,17,18,2,6,13
"E00033060",101,45,32,13,56,2,16,10,8,0,3,17
"E00033061",91,27,15,12,64,2,12,13,9,3,8,17
"E00033062",105,30,20,10,75,1,19,15,10,2,7,21
"E00033063",101,19,9,10,82,3,18,11,18,3,9,20
"E00033064",97,23,5,18,74,4,14,20,17,2,3,14
"E00033065",120,29,17,12,91,2,11,18,32,5,5,18
"E00033066",155,88,13,75,67,3,5,10,47,0,1,1
"E00033067",184,120,17,103,64,5,4,6,39,0,4,6
"E00033068",203,115,7,108,88,2,2,7,64,2,2,9
"E00033069",164,102,12,90,62,5,2,8,42,0,1,4
"E00033070",190,129,15,114,61,10,4,4,40,0,1,2
"E00033071",141,61,6,55,80,5,8,9,48,3,0,7
"E00033072",167,82,4,78,85,7,1,4,61,0,1,11
"E00033073",192,140,32,108,52,1,2,3,44,0,1,1
"E00033074",179,122,13,109,57,16,0,10,19,0,2,10
"E00033075",210,188,52,136,22,2,2,5,13,0,0,0
"E00033076",152,68,23,45,84,3,21,14,26,2,7,11
"E00033077",185,113,29,84,72,4,5,11,38,0,1,13
"E00033078",176,117,17,100,59,8,12,8,17,1,3,10
"E00033079",116,61,15,46,55,2,6,11,18,4,1,13
"E00033080",150,114,32,82,36,9,8,4,14,0,0,1
"E00033081",127,62,15,47,65,3,9,13,32,1,0,7
"E00033082",122,22,13,9,100,2,23,15,25,5,7,23
"E00033083",122,23,6,17,99,2,21,7,24,8,13,24
"E00033084",148,59,28,31,89,9,18,19,15,3,6,19
"E00033085",143,51,21,30,92,7,19,13,21,2,10,20
"E00033086",122,35,29,6,87,3,38,10,19,1,1,15
"E00033087",149,36,7,29,113,10,11,23,23,3,18,25
"E00033088",101,26,18,8,75,1,13,8,24,3,6,20
"E00033089",124,42,23,19,82,10,8,17,16,3,8,20
"E00033090",139,26,13,13,113,2,20,20,26,3,14,28
"E00033091",126,28,16,12,98,3,20,7,26,3,8,31
"E00033092",127,32,19,13,95,0,24,21,17,2,5,26
"E00033093",158,48,22,26,110,10,20,18,19,3,8,32
"E00033094",136,35,18,17,101,4,27,19,15,2,8,26
"E00033095",164,35,17,18,129,6,24,17,34,3,12,33
"E00033096",110,30,21,9,80,1,30,18,9,2,4,16
"E00033097",119,35,13,22,84,9,17,12,20,1,5,20
"E00033098",113,21,14,7,92,1,33,9,22,7,3,17
"E00033099",94,57,55,2,37,0,11,6,8,0,3,9
"E00033100",138,52,27,25,86,9,19,9,23,1,8,17
"E00033101",96,34,22,12,62,0,19,9,15,2,2,15
"E00033102",207,82,16,66,125,16,17,23,41,1,11,16
"E00033103",117,32,17,15,85,2,18,6,16,4,14,25
"E00033104",109,34,14,20,75,6,17,10,15,4,9,14
"E00033105",118,31,23,8,87,1,20,13,15,0,12,26
"E00033106",125,37,16,21,88,6,18,15,23,1,7,18
"E00033107",121,17,8,9,104,9,17,7,21,4,15,31
"E00033108",119,22,13,9,97,13,14,10,24,2,15,19
"E00033109",123,28,17,11,95,2,18,17,21,3,11,23
"E00033110",142,33,12,21,109,9,26,16,22,1,9,26
"E00033112",115,23,13,10,92,1,17,17,21,2,11,23
"E00033113",117,38,18,20,79,2,17,11,28,0,6,15
"E00033114",113,18,5,13,95,0,28,18,18,5,5,21
"E00033115",92,62,26,36,30,0,14,3,8,0,0,5
"E00033116",101,73,34,39,28,1,12,1,9,0,0,5
"E00033117",154,44,37,7,110,3,23,26,23,4,10,21
"E00033118",129,24,15,9,105,3,21,20,22,0,8,31
"E00033119",109,30,20,10,79,1,23,16,15,3,7,14
"E00033120",132,42,21,21,90,6,19,24,17,1,8,15
"E00033121",119,53,31,22,66,4,30,9,13,1,2,7
"E00033122",121,36,22,14,85,3,27,16,18,1,4,16
"E00033123",123,40,33,7,83,3,38,11,12,1,6,12
"E00033124",120,34,14,20,86,6,11,12,14,4,12,27
"E00033125",111,64,13,51,47,8,8,5,14,2,0,10
"E00033126",111,30,18,12,81,1,24,8,17,1,5,25
"E00033127",194,73,29,44,121,6,19,26,28,0,7,35
"E00033128",111,36,19,17,75,9,11,12,19,1,10,13
"E00033129",108,30,19,11,78,3,32,8,7,1,4,23
"E00033130",126,23,11,12,103,3,17,14,21,5,11,32
"E00033131",130,64,42,22,66,8,11,10,14,2,9,12
"E00033132",158,40,12,28,118,13,12,23,23,3,14,30
"E00033133",144,35,25,10,109,21,18,16,15,1,17,21
"E00033134",111,62,12,50,49,11,8,8,12,1,2,7
"E00033135",183,54,18,36,129,29,17,21,21,5,13,23
"E00033136",99,37,15,22,62,14,11,7,6,4,7,13
"E00033137",167,97,15,82,70,26,9,10,13,1,3,8
"E00033138",113,76,14,62,37,10,3,6,10,0,1,7
"E00033139",149,83,32,51,66,5,20,2,23,0,4,12
"E00033140",94,34,14,20,60,14,9,7,9,1,5,15
"E00033141",85,28,13,15,57,8,7,11,8,1,4,18
"E00033142",117,39,12,27,78,11,9,11,24,2,9,12
"E00033143",127,68,8,60,59,25,4,7,7,4,4,8
"E00033144",126,70,17,53,56,15,5,6,27,0,1,2
"E00033145",122,34,12,22,88,21,10,14,18,1,8,16
"E00033146",124,41,11,30,83,12,11,12,16,5,7,20
"E00033147",127,44,20,24,83,9,6,9,20,2,13,24
"E00033148",116,38,16,22,78,15,10,17,16,2,5,13
"E00033149",98,32,9,23,66,7,13,10,18,2,5,11
"E00033150",146,55,7,48,91,27,4,14,25,2,9,10
"E00033151",125,65,15,50,60,14,7,11,7,0,10,11
"E00033152",146,62,6,56,84,14,9,11,22,2,6,20
"E00033153",167,73,21,52,94,15,17,18,15,2,5,22
"E00033154",102,68,10,58,34,6,5,7,9,0,0,7
"E00033155",155,81,30,51,74,24,14,8,18,2,3,5
"E00033156",122,61,12,49,61,7,9,6,19,2,4,14
"E00033157",140,55,14,41,85,21,5,22,16,3,3,15
"E00033158",130,40,8,32,90,32,4,17,19,0,7,11
"E00033159",87,31,8,23,56,25,5,11,7,0,2,6
"E00033160",167,85,13,72,82,17,13,9,9,4,12,18
"E00033161",137,71,50,21,66,6,5,13,14,1,10,17
"E00033162",131,70,7,63,61,16,5,8,7,1,10,14
"E00033163",136,70,6,64,66,16,2,5,16,0,6,21
"E00033164",152,42,10,32,110,20,7,21,30,1,3,28
"E00033165",117,90,49,41,27,4,7,2,5,0,7,2
"E00033166",113,81,27,54,32,2,18,4,3,0,1,4
"E00033167",130,31,7,24,99,13,26,18,19,2,7,14
"E00033168",122,35,23,12,87,3,22,12,20,3,9,18
"E00033169",122,34,17,17,88,8,15,11,14,3,4,33
"E00033170",142,35,14,21,107,16,11,15,21,1,10,33
"E00033171",136,37,15,22,99,9,10,20,21,1,9,29
"E00033172",122,90,3,87,32,1,4,2,12,2,5,6
"E00033173",129,42,18,24,87,4,17,13,11,1,9,32
"E00033174",114,32,13,19,82,19,10,11,11,5,8,18
"E00033175",107,26,8,18,81,8,18,10,16,4,11,14
"E00033176",99,28,8,20,71,12,4,8,13,4,11,19
"E00033177",130,40,16,24,90,17,17,11,16,4,6,19
"E00033178",88,45,11,34,43,5,13,5,7,1,4,8
"E00033179",136,39,10,29,97,14,16,17,22,4,7,17
"E00033181",155,65,7,58,90,2,7,8,23,5,8,37
"E00033182",184,109,16,93,75,7,2,14,26,1,3,22
"E00033183",207,91,8,83,116,3,4,5,39,0,9,56
"E00033185",117,38,2,36,79,3,4,7,16,5,3,41
"E00033186",105,29,3,26,76,3,1,6,19,2,3,42
"E00033187",129,80,5,75,49,1,3,4,32,0,1,8
"E00033188",113,24,7,17,89,5,5,3,23,0,8,45
"E00033189",208,79,19,60,129,28,10,15,26,5,13,32
"E00033190",226,79,13,66,147,41,6,28,22,19,13,18
"E00033191",128,18,5,13,110,5,7,3,16,2,5,72
"E00033192",118,25,10,15,93,2,4,4,15,5,1,62
"E00033193",114,31,6,25,83,5,8,8,23,0,5,34
"E00033194",117,30,8,22,87,3,5,7,23,1,5,43
"E00033195",105,24,7,17,81,4,9,8,33,0,5,22
"E00033196",137,102,3,99,35,2,3,3,19,1,2,5
"E00033197",236,146,60,86,90,5,31,5,34,0,2,13
"E00033198",135,28,9,19,107,5,11,19,27,1,3,41
"E00033199",137,102,47,55,35,1,13,2,12,0,1,6
"E00033200",126,85,40,45,41,7,11,3,8,0,1,11
"E00033201",91,19,7,12,72,3,4,6,29,3,1,26
"E00033202",98,20,3,17,78,2,4,13,15,2,0,42
"E00033203",101,29,11,18,72,11,8,8,12,2,3,28
"E00033204",105,27,3,24,78,4,6,11,29,0,3,25
"E00033206",117,71,6,65,46,4,5,8,24,0,1,4
"E00033207",179,103,7,96,76,29,9,5,21,4,3,5
"E00033208",143,79,2,77,64,17,4,14,15,2,3,9
"E00033209",208,149,40,109,59,14,5,6,21,1,4,8
"E00033210",133,78,13,65,55,8,3,13,8,2,8,13
"E00033211",145,50,11,39,95,17,6,14,23,8,7,20
"E00033212",123,30,11,19,93,23,13,12,23,6,9,7
"E00033213",136,38,15,23,98,4,5,8,18,0,5,58
"E00033214",223,80,10,70,143,33,6,24,45,6,8,21
"E00033215",147,69,8,61,78,17,2,13,19,6,8,13
"E00033216",150,88,6,82,62,15,3,9,28,0,4,3
"E00033217",158,87,11,76,71,7,3,8,36,1,3,13
"E00033218",106,25,6,19,81,5,7,16,11,5,8,29
"E00033219",181,99,13,86,82,3,6,11,34,1,1,26
"E00033220",135,42,8,34,93,3,3,8,24,0,1,54
"E00033221",170,134,4,130,36,4,0,2,15,0,2,13
"E00033222",135,107,56,51,28,5,12,3,5,1,0,2
"E00033223",171,124,9,115,47,4,1,1,29,1,2,9
"E00033224",148,62,35,27,86,13,20,10,17,4,4,18
"E00033225",160,100,9,91,60,19,2,13,6,4,7,9
"E00033226",187,73,21,52,114,29,12,8,21,7,9,28
"E00033227",136,76,43,33,60,12,7,4,9,0,7,21
"E00033228",208,138,45,93,70,11,18,10,11,3,6,11
"E00033229",128,47,25,22,81,2,19,9,17,0,10,24
"E00033230",114,26,14,12,88,5,22,8,23,1,11,18
"E00033231",113,64,17,47,49,12,5,4,15,2,3,8
"E00033235",122,64,19,45,58,11,6,4,21,2,6,8
"E00033237",146,73,24,49,73,13,20,8,15,2,6,9
"E00033238",182,53,20,33,129,17,24,17,13,4,15,39
"E00033242",104,35,18,17,69,9,13,8,11,0,5,23
"E00033245",167,90,41,49,77,13,14,8,21,1,8,12
"E00033246",121,57,13,44,64,8,5,8,17,2,6,18
"E00033247",148,48,16,32,100,21,8,23,20,2,6,20
"E00033248",250,212,44,168,38,12,3,3,18,0,0,2
"E00033249",132,55,14,41,77,18,6,15,17,2,8,11
"E00033250",126,61,13,48,65,24,8,10,15,0,1,7
"E00033251",106,44,9,35,62,16,8,11,12,3,2,10
"E00033252",169,81,43,38,88,23,14,11,11,3,11,15
"E00033253",132,77,37,40,55,14,6,8,7,3,2,15
"E00033254",152,43,15,28,109,17,21,12,23,0,12,24
"E00033255",126,49,18,31,77,9,22,5,14,4,4,19
"E00033256",100,34,21,13,66,8,12,9,18,2,7,10
"E00033257",180,101,28,73,79,8,19,5,26,3,3,15
"E00033258",157,61,31,30,96,20,35,10,6,3,4,18
"E00033259",80,43,6,37,37,11,6,6,10,1,0,3
"E00033260",129,63,23,40,66,12,6,9,18,2,2,17
"E00033261",110,39,9,30,71,11,7,9,18,2,11,13
"E00033262",96,52,11,41,44,13,6,5,16,0,1,3
"E00033263",89,55,8,47,34,7,3,8,8,0,0,8
"E00033264",147,73,30,43,74,22,13,7,18,2,2,10
"E00033265",126,47,17,30,79,5,13,10,15,4,12,20
"E00033266",147,65,18,47,82,6,17,11,10,2,9,27
"E00033267",141,82,45,37,59,16,12,9,6,1,4,11
"E00033268",121,39,21,18,82,1,11,13,22,2,8,25
"E00033269",92,55,32,23,37,1,7,6,6,1,5,11
"E00033270",128,31,16,15,97,5,13,19,20,2,15,23
"E00033271",126,18,14,4,108,6,8,18,18,9,9,40
"E00033272",120,27,11,16,93,4,19,17,22,1,11,19
"E00033274",122,61,15,46,61,5,9,14,10,4,5,14
"E00033275",142,70,48,22,72,2,19,9,13,6,4,19
"E00033276",127,68,13,55,59,14,2,13,21,1,1,7
"E00033277",99,33,20,13,66,8,11,15,12,2,4,14
"E00033278",107,39,14,25,68,11,13,9,17,4,4,10
"E00033279",139,53,13,40,86,27,13,12,19,1,3,11
"E00033281",136,47,12,35,89,14,15,12,21,3,8,16
"E00033282",125,35,20,15,90,9,18,11,17,4,8,23
"E00033283",118,38,23,15,80,2,21,11,15,1,7,23
"E00033284",182,143,23,120,39,15,2,1,12,1,4,4
"E00033285",135,54,21,33,81,6,17,17,16,1,8,16
"E00033286",128,79,52,27,49,2,14,7,12,2,4,8
"E00033287",115,30,10,20,85,9,11,17,20,3,13,12
"E00033288",121,29,13,16,92,8,7,27,18,3,6,23
"E00033289",105,37,11,26,68,5,9,9,22,0,6,17
"E00033290",88,22,5,17,66,7,6,14,13,3,6,17
"E00033291",185,31,13,18,154,25,11,36,38,6,13,25
"E00033292",106,47,7,40,59,4,11,12,22,1,1,8
"E00033293",145,54,34,20,91,17,13,12,19,1,9,20
"E00033294",130,68,19,49,62,19,4,7,19,1,2,10
"E00033295",108,21,15,6,87,7,19,21,17,1,6,16
"E00033296",111,31,19,12,80,2,22,9,14,2,8,23
"E00033297",143,58,27,31,85,5,14,14,20,1,9,22
"E00033298",129,51,23,28,78,3,20,8,9,5,11,22
"E00033299",117,38,28,10,79,1,19,10,16,5,9,19
"E00033300",112,45,15,30,67,4,16,10,17,1,5,14
"E00033301",120,32,17,15,88,20,9,19,14,1,4,21
"E00033302",105,36,24,12,69,14,8,9,24,1,7,6
"E00033304",102,22,8,14,80,4,18,8,21,3,7,19
"E00033305",121,45,15,30,76,4,18,10,15,4,10,15
"E00033306",122,47,22,25,75,9,11,10,17,1,12,15
"E00033307",124,30,16,14,94,21,13,16,17,4,5,18
"E00033308",122,42,23,19,80,12,9,19,13,2,5,20
"E00033309",135,40,14,26,95,20,18,15,16,4,5,17
"E00033310",127,25,12,13,102,24,17,18,11,3,10,19
"E00033312",133,55,18,37,78,8,20,7,17,2,5,19
"E00033313",137,27,13,14,110,23,15,12,27,5,6,22
"E00033314",130,40,21,19,90,7,14,17,19,4,9,20
"E00033315",130,30,20,10,100,9,18,13,17,2,14,27
"E00033316",144,42,26,16,102,9,14,27,31,1,5,15
"E00033317",152,35,14,21,117,3,23,23,36,1,9,22
"E00033318",153,46,19,27,107,16,17,6,26,4,7,31
"E00033319",164,38,19,19,126,1,23,28,29,6,7,32
"E00033320",130,36,23,13,94,2,19,21,24,0,4,24
"E00033322",118,23,10,13,95,2,25,14,22,4,6,22
"E00033323",107,14,12,2,93,2,21,18,14,3,12,23
"E00033324",113,20,12,8,93,2,14,19,26,2,12,18
"E00033326",106,14,9,5,92,1,22,22,16,3,7,21
"E00033327",124,39,27,12,85,2,14,19,21,1,12,16
"E00033328",119,53,22,31,66,4,13,12,9,1,8,19
"E00033329",131,35,17,18,96,4,21,19,16,0,9,27
"E00033330",130,31,19,12,99,5,21,20,25,1,10,17
"E00033331",134,35,28,7,99,2,28,26,12,3,6,22
"E00033332",108,16,8,8,92,3,15,19,13,4,12,26
"E00033333",121,26,15,11,95,3,21,19,15,7,11,19
"E00033334",108,17,6,11,91,4,15,15,21,4,10,22
"E00033335",108,31,16,15,77,2,18,11,20,2,8,16
"E00033336",121,23,15,8,98,5,12,23,23,4,10,21
"E00033337",85,27,14,13,58,2,12,11,13,1,5,14
"E00033338",90,8,2,6,82,4,17,16,15,3,13,14
"E00033339",132,38,13,25,94,5,17,13,13,5,17,24
"E00033340",103,9,6,3,94,2,15,26,17,5,6,23
"E00033341",115,19,14,5,96,3,20,20,21,2,11,19
"E00033342",126,29,15,14,97,2,27,15,15,5,10,23
"E00033343",96,16,8,8,80,2,10,20,17,1,8,22
"E00033344",139,36,16,20,103,3,20,31,23,1,3,22
"E00033345",129,18,11,7,111,3,19,28,16,2,15,28
"E00033346",124,45,21,24,79,1,10,20,19,3,7,19
"E00033347",121,26,15,11,95,3,16,22,21,2,10,21
"E00033348",112,29,23,6,83,1,19,15,15,4,9,20
"E00033349",154,90,13,77,64,9,13,6,21,4,4,7
"E00033350",122,23,13,10,99,3,23,18,23,3,12,17
"E00033351",124,34,13,21,90,9,24,10,13,3,15,16
"E00033352",108,34,11,23,74,9,13,14,12,2,6,18
"E00033353",103,19,13,6,84,5,15,13,23,3,4,21
"E00033354",150,107,37,70,43,2,5,9,22,1,0,4
"E00033355",113,33,12,21,80,3,9,18,25,2,8,15
"E00033356",137,36,20,16,101,6,21,12,24,3,14,21
"E00033357",125,47,30,17,78,12,18,6,15,0,5,22
"E00033358",95,28,11,17,67,10,13,10,15,3,2,14
"E00033359",161,73,27,46,88,6,17,16,22,4,5,18
"E00033360",155,49,20,29,106,8,26,24,17,1,9,21
"E00033361",174,45,23,22,129,10,18,28,35,2,12,24
"E00033362",106,27,18,9,79,2,9,23,18,3,6,18
"E00033363",87,29,10,19,58,4,6,15,19,1,2,11
"E00033364",134,25,19,6,109,3,22,23,20,2,13,26
"E00033365",172,41,21,20,131,7,13,27,31,6,13,34
"E00033366",108,22,17,5,86,4,12,18,19,3,6,24
"E00033367",137,48,6,42,89,5,8,12,24,6,3,31
"E00033368",124,44,23,21,80,3,11,11,35,3,8,9
"E00033369",137,24,10,14,113,2,8,29,34,3,12,25
"E00033370",141,64,43,21,77,5,12,14,27,1,2,16
"E00033371",124,29,17,12,95,2,19,17,26,4,3,24
"E00033372",112,28,5,23,84,6,8,12,22,4,16,16
"E00033373",181,42,12,30,139,5,24,27,32,8,10,33
"E00033374",140,53,26,27,87,6,16,16,37,2,1,9
"E00033375",140,42,22,20,98,2,27,11,19,5,12,22
"E00033376",135,46,29,17,89,3,29,17,19,2,2,17
"E00033377",133,41,18,23,92,0,19,16,29,1,8,19
"E00033378",137,40,19,21,97,5,15,19,23,4,7,24
"E00033379",130,45,17,28,85,12,8,21,28,2,0,14
"E00033380",106,28,13,15,78,1,14,13,28,2,4,16
"E00033381",130,78,51,27,52,2,19,11,12,0,1,7
"E00033382",123,25,13,12,98,2,15,18,19,4,10,30
"E00033383",133,48,19,29,85,8,12,21,26,0,1,17
"E00033384",146,32,21,11,114,8,25,14,30,4,6,27
"E00033385",156,63,15,48,93,6,11,15,35,1,3,22
"E00033386",140,32,9,23,108,9,9,20,27,5,6,32
"E00033387",122,71,7,64,51,2,1,7,25,1,4,11
"E00033388",162,86,24,62,76,10,18,7,23,3,3,12
"E00033389",118,33,8,25,85,6,10,24,25,1,8,11
"E00033391",164,65,8,57,99,16,12,17,24,0,5,25
"E00033392",149,85,13,72,64,7,4,8,20,0,10,15
"E00033394",139,70,10,60,69,1,3,9,25,3,6,22
"E00033395",156,77,7,70,79,3,9,8,40,1,4,14
"E00033396",126,45,17,28,81,3,16,15,15,1,5,26
"E00033397",125,34,16,18,91,2,12,24,21,4,12,16
"E00033399",128,23,14,9,105,6,20,22,24,3,8,22
"E00033400",118,33,21,12,85,4,12,23,15,2,4,25
"E00033401",102,17,10,7,85,6,13,20,21,4,6,15
"E00033402",134,31,6,25,103,4,11,14,35,0,4,35
"E00033403",144,34,13,21,110,2,22,14,31,2,6,33
"E00033404",162,70,15,55,92,3,16,11,30,3,3,26
"E00033405",129,30,6,24,99,5,18,18,34,3,6,15
"E00033406",126,30,19,11,96,4,14,21,20,4,9,24
"E00033407",138,45,12,33,93,6,8,13,28,2,2,34
"E00033408",123,38,16,22,85,0,10,13,19,1,8,34
"E00033409",166,80,66,14,86,4,39,9,13,3,4,14
"E00033410",121,38,11,27,83,5,4,14,21,0,4,35
"E00033411",119,29,19,10,90,2,17,10,13,3,14,31
"E00033412",146,47,21,26,99,5,10,15,33,2,5,29
"E00033413",111,45,6,39,66,4,9,13,18,1,2,19
"E00033414",135,45,12,33,90,7,8,20,29,2,4,20
"E00033415",94,11,6,5,83,0,14,15,21,6,8,19
"E00033416",144,40,11,29,104,6,4,18,37,4,4,31
"E00033417",144,44,14,30,100,4,15,18,29,1,7,26
"E00033418",144,22,16,6,122,0,26,18,24,7,19,28
"E00033419",119,31,20,11,88,2,16,17,17,4,7,25
"E00033420",155,42,17,25,113,6,13,14,30,2,5,43
"E00033421",128,48,15,33,80,5,9,12,17,3,11,23
"E00033422",172,31,11,20,141,2,25,24,33,7,11,39
"E00033423",126,38,12,26,88,2,7,15,28,2,5,29
"E00033424",134,41,12,29,93,7,10,11,35,3,3,24
"E00033425",124,52,11,41,72,9,3,12,32,0,5,11
"E00033426",121,34,11,23,87,1,10,10,29,1,11,25
"E00033427",105,30,14,16,75,5,21,12,15,3,4,15
"E00033428",124,29,7,22,95,16,13,17,22,3,8,16
"E00033432",135,46,24,22,89,9,19,12,15,5,8,21
"E00033435",125,40,20,20,85,2,15,10,22,1,13,22
"E00033436",128,41,12,29,87,13,17,9,25,1,7,15
"E00033437",114,38,18,20,76,3,17,14,16,1,13,12
"E00033438",127,32,13,19,95,6,17,14,26,4,8,20
"E00033439",173,56,21,35,117,19,23,11,35,1,7,21
"E00033440",139,37,16,21,102,27,15,18,17,10,5,10
"E00033441",141,56,19,37,85,17,18,12,15,3,8,12
"E00033442",134,43,19,24,91,3,18,12,15,5,14,24
"E00033443",72,29,13,16,43,5,4,6,13,1,5,9
"E00033444",115,37,17,20,78,13,16,10,17,1,5,16
"E00033445",98,24,14,10,74,8,11,11,10,1,10,23
"E00033446",121,39,18,21,82,6,18,7,16,1,10,24
"E00033447",94,59,44,15,35,3,9,5,8,0,3,7
"E00033448",124,40,15,25,84,9,15,11,12,3,12,22
"E00033449",143,54,18,36,89,13,19,11,22,2,3,19
"E00033450",121,36,19,17,85,10,15,9,14,1,9,27
"E00033451",109,55,18,37,54,6,6,7,13,3,9,10
"E00033452",110,41,20,21,69,5,14,8,19,1,3,19
"E00033453",78,40,2,38,38,5,9,3,9,1,2,9
"E00033454",219,81,21,60,138,26,17,29,31,6,8,21
"E00033455",122,59,10,49,63,18,11,8,13,1,4,8
"E00033456",133,38,18,20,95,7,16,13,17,4,11,27
"E00033457",95,31,8,23,64,23,5,10,12,2,3,9
"E00033458",87,19,6,13,68,17,5,9,13,4,6,14
"E00033459",143,83,49,34,60,5,10,11,10,2,4,18
"E00033460",79,24,5,19,55,6,2,24,10,0,4,9
"E00033462",94,28,16,12,66,10,12,4,18,4,6,12
"E00033463",103,36,19,17,67,11,19,5,14,0,3,15
"E00033464",116,32,15,17,84,9,13,9,25,3,6,19
"E00033466",122,36,15,21,86,12,18,10,16,0,7,23
"E00033468",119,33,17,16,86,12,19,6,12,2,8,27
"E00033470",130,39,15,24,91,13,15,15,14,3,10,21
"E00033471",107,26,13,13,81,11,19,11,11,5,8,16
"E00033472",105,36,16,20,69,14,12,10,12,3,4,14
"E00033473",116,34,11,23,82,11,15,9,19,2,7,19
"E00033474",145,87,19,68,58,12,11,7,21,1,1,5
"E00033475",157,86,18,68,71,14,9,20,17,4,1,6
"E00033476",115,59,19,40,56,4,10,5,10,0,9,18
"E00033477",74,20,7,13,54,3,8,9,14,1,5,14
"E00033478",115,32,18,14,83,9,17,8,21,5,8,15
"E00033479",167,51,25,26,116,17,22,17,19,1,7,33
"E00033480",108,24,9,15,84,3,12,11,24,2,11,21
"E00033481",172,53,30,23,119,25,27,16,17,2,8,24
"E00033482",117,32,19,13,85,6,15,6,19,3,9,27
"E00033483",166,83,47,36,83,11,10,13,21,4,4,20
"E00033484",121,37,13,24,84,8,14,12,18,2,4,26
"E00033485",137,46,22,24,91,14,19,12,14,3,6,23
"E00033486",165,59,15,44,106,26,9,17,28,0,5,21
"E00033487",157,108,50,58,49,6,13,8,8,1,1,12
"E00033488",149,90,14,76,59,19,3,8,21,1,0,7
"E00033489",122,35,20,15,87,5,20,12,12,1,14,23
"E00033490",108,32,16,16,76,8,18,9,14,3,9,15
"E00033491",142,88,17,71,54,16,4,9,16,0,1,8
"E00033492",195,104,24,80,91,24,13,7,27,1,3,16
"E00033493",142,56,14,42,86,20,10,11,22,0,5,18
"E00033494",103,32,17,15,71,9,8,10,15,3,5,21
"E00033495",161,60,19,41,101,29,12,16,21,0,9,14
"E00033496",152,68,22,46,84,22,13,12,16,4,1,16
"E00033497",98,32,11,21,66,9,10,4,19,1,7,16
"E00033498",91,76,11,65,15,3,3,1,7,0,1,0
"E00033501",98,80,19,61,18,5,3,0,8,1,0,1
"E00033502",104,34,13,21,70,12,5,15,18,1,5,14
"E00033503",100,29,10,19,71,9,6,20,16,1,8,11
"E00033504",129,31,12,19,98,14,19,15,16,2,8,24
"E00033505",93,31,13,18,62,7,12,11,12,0,6,14
"E00033506",124,44,16,28,80,17,13,10,7,3,8,22
"E00033507",136,65,10,55,71,19,7,5,24,0,5,11
"E00033508",132,81,49,32,51,12,8,3,8,0,8,12
"E00033509",113,25,10,15,88,21,13,12,17,1,7,17
"E00033510",137,46,15,31,91,18,10,10,25,2,3,23
"E00033511",122,55,12,43,67,14,9,11,18,2,3,10
"E00033512",78,19,3,16,59,4,7,8,14,1,11,14
"E00033513",130,51,13,38,79,14,11,15,15,4,11,9
"E00033514",114,50,28,22,64,8,15,9,11,2,6,13
"E00033515",125,48,7,41,77,11,12,10,18,2,6,18
"E00033516",110,35,11,24,75,6,10,16,19,1,2,21
"E00033517",126,39,17,22,87,9,18,9,16,4,8,23
"E00033518",121,48,13,35,73,17,7,15,19,0,8,7
"E00033519",139,48,19,29,91,20,13,19,13,3,9,14
"E00033520",102,49,11,38,53,9,11,10,13,0,3,7
"E00033521",142,79,11,68,63,17,12,11,10,1,1,11
"E00033522",151,70,15,55,81,17,15,18,19,1,2,9
"E00033523",144,38,15,23,106,19,19,17,23,2,7,19
"E00033524",217,100,30,70,117,23,15,17,37,2,6,17
"E00033525",131,33,18,15,98,11,20,15,16,1,7,28
"E00033526",128,42,10,32,86,9,16,22,28,1,1,9
"E00033527",153,47,34,13,106,7,19,18,18,2,13,29
"E00033528",126,54,19,35,72,6,13,11,21,2,6,13
"E00033530",145,11,4,7,134,7,17,31,27,5,14,33
"E00033531",134,19,8,11,115,5,28,22,22,3,10,25
"E00033532",166,47,26,21,119,6,19,19,33,1,11,30
"E00033533",96,22,12,10,74,5,18,12,16,1,4,18
"E00033534",124,55,24,31,69,5,20,7,28,0,1,8
"E00033535",133,38,15,23,95,7,23,14,22,1,5,23
"E00033536",127,36,17,19,91,4,13,17,20,2,7,28
"E00033537",132,48,22,26,84,8,17,18,15,1,7,18
"E00033538",147,41,22,19,106,4,28,15,28,1,5,25
"E00033539",130,32,7,25,98,7,10,19,33,4,3,22
"E00033540",135,44,13,31,91,6,13,13,23,4,7,25
"E00033541",129,36,20,16,93,3,22,17,16,1,11,23
"E00033542",124,51,17,34,73,5,20,17,11,2,4,14
"E00033543",120,51,22,29,69,5,16,11,16,1,6,14
"E00033544",104,31,9,22,73,9,15,16,19,0,4,10
"E00033545",121,48,25,23,73,9,20,10,16,2,5,11
"E00033546",148,43,23,20,105,7,18,8,27,2,14,29
"E00033547",126,38,9,29,88,8,16,19,22,6,2,15
"E00033548",113,44,10,34,69,4,13,18,24,2,3,5
"E00033549",151,51,31,20,100,7,31,9,17,1,13,22
"E00033550",124,35,21,14,89,5,17,20,17,2,7,21
"E00033551",102,43,38,5,59,4,19,6,7,2,7,14
"E00033552",124,26,18,8,98,5,22,17,18,6,7,23
"E00033553",161,69,53,16,92,5,20,16,17,1,10,23
"E00033554",115,15,10,5,100,3,22,9,20,4,12,30
"E00033555",136,62,31,31,74,4,24,10,13,2,3,18
"E00033556",114,23,12,11,91,4,21,21,12,5,8,20
"E00033557",124,26,18,8,98,1,23,26,16,3,6,23
"E00033558",114,22,10,12,92,4,18,19,18,1,8,24
"E00033559",110,32,18,14,78,4,19,7,19,2,4,23
"E00033560",113,19,9,10,94,0,25,13,16,2,11,27
"E00033561",106,23,15,8,83,3,13,13,13,1,9,31
"E00033562",117,18,11,7,99,0,19,15,22,3,5,35
"E00033563",131,21,9,12,110,2,31,8,24,3,12,30
"E00033564",144,41,18,23,103,4,22,11,26,2,11,27
"E00033565",117,20,10,10,97,5,25,11,23,0,12,21
"E00033566",148,72,48,24,76,5,15,15,13,4,11,13
"E00033567",127,24,14,10,103,8,14,29,21,4,8,19
"E00033568",144,47,24,23,97,16,14,17,16,6,5,23
"E00033569",102,32,14,18,70,3,13,14,12,0,7,21
"E00033570",173,64,20,44,109,8,11,34,31,1,8,16
"E00033571",121,47,30,17,74,7,22,9,17,0,3,16
"E00033572",117,34,22,12,83,3,22,7,16,1,10,24
"E00033573",95,48,4,44,47,5,5,8,16,1,5,7
"E00033574",118,26,12,14,92,6,11,19,16,1,12,27
"E00033575",111,42,29,13,69,0,16,7,15,1,4,26
"E00033576",109,38,26,12,71,2,20,12,16,0,3,18
"E00033577",120,35,21,14,85,2,17,15,18,1,9,23
"E00033579",123,29,8,21,94,21,11,12,20,2,15,13
"E00033580",152,85,14,71,67,10,13,9,25,1,2,7
"E00033581",221,86,16,70,135,24,15,28,31,6,10,21
"E00033582",159,70,21,49,89,13,16,11,16,0,4,29
"E00033583",110,41,11,30,69,3,11,12,23,0,4,16
"E00033584",107,36,12,24,71,5,8,6,33,3,5,11
"E00033585",135,44,12,32,91,6,10,14,36,2,4,19
"E00033586",143,62,21,41,81,7,10,8,32,2,2,20
"E00033587",153,67,30,37,86,5,27,10,16,1,2,25
"E00033589",136,36,8,28,100,20,18,15,27,2,3,15
"E00033590",79,31,9,22,48,13,7,7,9,1,4,7
"E00033591",94,26,13,13,68,12,17,11,12,4,5,7
"E00033592",118,19,9,10,99,19,14,23,18,0,9,16
"E00033593",100,44,16,28,56,20,6,9,12,1,3,5
"E00033594",143,38,16,22,105,17,17,18,18,4,10,21
"E00033595",157,80,42,38,77,14,9,11,20,3,7,13
"E00033596",143,62,26,36,81,19,6,15,23,3,4,11
"E00033597",105,40,8,32,65,8,14,13,12,1,5,12
"E00033598",124,69,19,50,55,10,6,14,18,0,1,6
"E00033599",125,63,15,48,62,26,4,9,14,1,3,5
"E00033600",139,77,46,31,62,12,16,9,12,0,5,8
"E00033601",140,62,10,52,78,28,7,9,19,1,1,13
"E00033602",131,46,9,37,85,1,11,11,36,0,3,23
"E00033603",136,53,22,31,83,16,11,5,23,4,12,12
"E00033604",138,66,19,47,72,20,5,7,28,0,0,12
"E00033605",125,43,10,33,82,5,7,10,27,2,7,24
"E00033606",114,40,7,33,74,5,2,12,31,2,1,21
"E00033607",118,57,16,41,61,22,4,12,16,1,0,6
"E00033608",144,52,23,29,92,10,14,9,22,4,12,21
"E00033611",122,28,7,21,94,3,13,7,30,0,8,33
"E00033613",125,60,42,18,65,5,11,10,16,0,3,20
"E00033614",139,34,9,25,105,6,8,12,40,2,8,29
"E00033616",141,28,11,17,113,1,16,18,33,4,9,32
"E00033618",159,47,15,32,112,8,14,14,36,1,8,31
"E00033620",118,27,13,14,91,3,11,19,26,4,6,22
"E00033621",103,27,7,20,76,8,5,16,15,5,7,20
"E00033623",181,67,16,51,114,17,22,11,39,2,5,18
"E00033624",125,45,19,26,80,13,15,7,15,2,7,21
"E00033625",123,28,11,17,95,3,11,25,22,7,7,20
"E00033626",172,47,4,43,125,12,4,49,33,6,12,9
"E00033627",142,38,3,35,104,14,7,36,29,7,5,6
"E00033628",139,47,18,29,92,22,11,14,22,4,7,12
"E00033629",179,43,10,33,136,15,16,26,40,6,12,21
"E00033630",128,67,16,51,61,10,9,6,19,0,6,11
"E00033631",129,83,44,39,46,8,7,7,7,1,9,7
"E00033632",149,48,13,35,101,39,7,17,19,5,4,10
"E00033633",101,26,15,11,75,5,18,11,22,3,6,10
"E00033634",158,61,28,33,97,20,16,18,16,1,10,16
"E00033635",132,61,20,41,71,4,17,8,14,1,9,18
"E00033636",167,43,13,30,124,25,10,26,34,6,6,17
"E00033637",196,56,12,44,140,30,5,29,35,7,14,20
"E00033639",129,34,11,23,95,23,12,15,22,4,5,14
"E00033640",128,42,16,26,86,12,11,17,16,4,7,19
"E00033641",127,32,17,15,95,2,24,13,26,1,10,19
"E00033642",145,38,25,13,107,5,25,10,22,5,10,30
"E00033643",109,38,11,27,71,19,9,16,16,1,1,9
"E00033644",95,26,10,16,69,25,6,7,10,4,3,14
"E00033645",109,36,14,22,73,18,7,7,20,3,8,10
"E00033646",41,14,4,10,27,4,5,7,0,0,5,6
"E00033647",99,24,9,15,75,11,4,14,18,4,6,18
"E00033648",127,55,22,33,72,7,11,5,23,5,2,19
"E00033649",115,21,0,21,94,17,0,31,31,3,8,4
"E00033650",134,53,18,35,81,16,10,13,16,3,7,16
"E00033651",58,15,5,10,43,13,4,10,5,1,3,7
"E00033652",132,49,18,31,83,21,10,11,19,3,6,13
"E00033653",105,24,1,23,81,8,2,30,21,4,8,8
"E00033654",79,16,6,10,63,10,8,7,13,4,7,14
"E00033655",186,62,16,46,124,35,14,26,20,4,13,12
"E00033656",83,22,10,12,61,12,6,11,13,4,7,8
"E00033657",84,22,10,12,62,10,11,10,10,5,6,10
"E00033658",129,33,5,28,96,19,8,27,21,2,4,15
"E00033659",157,43,13,30,114,12,18,19,23,7,10,25
"E00033660",132,35,13,22,97,17,20,15,21,4,5,15
"E00033662",155,45,21,24,110,27,18,12,18,4,6,25
"E00033663",122,77,16,61,45,5,6,3,10,4,4,13
"E00033664",138,88,43,45,50,5,15,8,7,1,5,9
"E00033665",167,36,15,21,131,20,12,36,24,5,11,23
"E00033666",130,73,37,36,57,18,10,11,8,1,3,6
"E00033667",142,57,19,38,85,15,19,9,16,0,4,22
"E00033668",114,36,9,27,78,7,16,13,11,1,3,27
"E00033669",125,36,18,18,89,18,15,9,19,2,8,18
"E00033670",177,93,4,89,84,4,1,6,65,0,4,4
"E00033672",159,51,14,37,108,21,10,13,29,3,13,19
"E00033673",124,52,15,37,72,18,13,8,16,0,5,12
"E00033677",120,57,29,28,63,5,15,6,16,0,4,17
"E00033678",194,123,36,87,71,3,6,5,42,0,3,12
"E00033684",212,94,40,54,118,16,17,13,38,0,8,26
"E00033685",130,40,17,23,90,21,17,9,13,5,11,14
"E00033686",129,51,19,32,78,19,12,14,15,3,6,9
"E00033687",162,56,13,43,106,15,7,17,25,4,11,27
"E00033688",118,46,16,30,72,15,8,7,14,6,5,17
"E00033689",145,54,30,24,91,17,17,12,14,8,8,15
"E00033690",169,65,25,40,104,11,10,9,40,3,2,29
"E00033691",107,48,8,40,59,5,8,11,15,1,4,15
"E00033692",201,117,8,109,84,1,4,4,70,0,1,4
"E00033694",114,51,10,41,63,22,6,8,9,2,7,9
"E00033695",137,50,12,38,87,17,14,18,17,3,5,13
"E00033696",205,71,30,41,134,28,28,14,35,1,9,19
"E00033697",145,44,19,25,101,10,18,16,26,6,10,15
"E00033698",165,40,15,25,125,13,20,25,25,3,9,30
"E00033699",143,39,19,20,104,11,13,22,30,0,8,20
"E00033700",97,34,12,22,63,12,13,11,12,1,3,11
"E00033701",136,27,9,18,109,10,8,22,25,6,11,27
"E00033702",103,68,38,30,35,3,7,6,10,0,3,6
"E00033703",167,106,46,60,61,5,19,10,11,1,2,13
"E00033704",125,15,1,14,110,9,5,36,19,5,20,16
"E00033705",133,20,5,15,113,5,6,32,35,3,7,25
"E00033706",116,47,17,30,69,11,20,10,5,3,6,14
"E00033707",119,47,13,34,72,9,8,11,26,1,3,14
"E00033708",117,67,22,45,50,5,15,2,14,0,1,13
"E00033709",76,22,12,10,54,8,5,10,8,2,10,11
"E00033710",137,49,20,29,88,17,8,17,21,4,2,19
"E00033711",70,37,10,27,33,7,8,5,6,0,1,6
"E00033712",124,17,10,7,107,9,12,12,20,5,15,34
"E00033713",127,45,13,32,82,4,16,22,23,1,5,11
"E00033715",162,51,4,47,111,28,8,23,25,3,5,19
"E00033716",121,80,26,54,41,3,7,4,13,4,4,6
"E00033717",103,35,6,29,68,7,6,32,13,2,5,3
"E00033718",132,27,2,25,105,13,10,27,35,2,8,10
"E00033719",127,25,2,23,102,5,4,36,28,3,14,12
"E00033720",135,35,18,17,100,8,21,12,22,2,5,30
"E00033721",113,20,2,18,93,8,5,28,19,2,16,15
"E00033722",94,23,17,6,71,10,13,9,17,0,5,17
"E00033723",135,24,17,7,111,4,14,27,28,4,8,26
"E00033724",134,46,25,21,88,5,13,14,20,3,13,20
"E00033725",145,53,16,37,92,8,16,17,21,5,7,18
"E00033726",103,37,9,28,66,5,11,6,16,3,6,19
"E00033727",138,48,24,24,90,14,15,15,20,1,7,18
"E00033728",141,13,0,13,128,3,9,25,26,4,21,40
"E00033729",99,33,10,23,66,15,7,13,12,1,5,13
"E00033730",127,31,15,16,96,11,19,20,22,3,8,13
"E00033731",87,43,8,35,44,13,3,8,12,2,1,5
"E00033732",125,37,12,25,88,7,19,18,21,1,6,16
"E00033733",102,28,9,19,74,10,11,12,19,2,4,16
"E00033734",111,42,10,32,69,17,10,13,17,4,3,5
"E00033735",94,80,67,13,14,0,6,0,6,0,0,2
"E00033736",126,57,14,43,69,11,7,14,22,2,3,10
"E00033737",145,40,8,32,105,5,14,22,19,7,11,27
"E00033738",97,45,15,30,52,7,14,4,10,3,2,12
"E00033739",105,29,10,19,76,16,8,12,15,4,5,16
"E00033740",140,48,18,30,92,12,17,16,20,1,6,20
"E00033741",134,54,15,39,80,14,14,13,22,3,4,10
"E00033742",130,40,8,32,90,19,12,15,22,2,4,16
"E00033743",108,32,10,22,76,9,7,15,16,4,9,16
"E00033744",146,46,23,23,100,15,17,19,16,2,9,22
"E00033745",119,67,44,23,52,11,21,6,7,0,3,4
"E00033746",124,36,15,21,88,13,20,9,21,4,4,17
"E00033747",146,45,8,37,101,17,7,21,13,3,13,27
"E00033748",119,38,19,19,81,14,13,15,16,1,6,16
"E00033749",118,39,15,24,79,7,10,10,24,2,7,19
"E00033750",137,40,6,34,97,9,4,33,20,7,4,20
"E00033752",189,62,18,44,127,26,19,22,32,3,9,16
"E00033753",108,25,9,16,83,10,15,16,25,2,5,10
"E00033754",126,35,6,29,91,10,6,25,25,5,5,15
"E00033755",118,23,6,17,95,6,7,22,27,3,8,22
"E00033756",133,31,3,28,102,20,5,34,30,1,5,7
"E00033758",112,34,17,17,78,6,14,12,24,1,3,18
"E00033759",99,50,34,16,49,10,10,5,6,3,7,8
"E00033762",122,35,8,27,87,14,6,11,24,3,9,20
"E00033763",125,26,5,21,99,15,3,28,27,0,16,10
"E00033764",133,14,4,10,119,13,4,33,31,5,10,23
"E00033765",131,43,20,23,88,5,17,17,16,1,14,18
"E00033766",123,18,6,12,105,7,6,21,16,7,24,24
"E00033767",117,29,5,24,88,8,7,24,29,3,6,11
"E00033768",116,35,13,22,81,4,11,14,23,3,5,21
"E00033769",130,89,64,25,41,1,10,11,9,1,2,7
"E00033770",127,9,0,9,118,4,2,28,23,6,22,33
"E00033771",132,18,3,15,114,19,3,30,32,4,11,15
"E00033773",114,27,17,10,87,5,17,15,22,2,8,18
"E00033774",130,44,17,27,86,4,13,17,27,2,5,18
"E00033775",185,53,8,45,132,26,12,23,35,5,18,13
"E00033776",146,72,53,19,74,11,13,7,15,0,7,21
"E00033777",109,18,3,15,91,10,20,22,20,0,4,15
"E00033778",128,32,6,26,96,6,4,37,22,4,12,11
"E00033779",132,55,11,44,77,17,4,11,22,6,5,12
"E00033780",104,22,9,13,82,6,18,15,17,1,5,20
"E00033781",170,85,38,47,85,10,14,11,18,5,7,20
"E00033782",131,40,16,24,91,11,18,17,20,1,9,15
"E00033783",120,32,11,21,88,6,10,19,18,5,12,18
"E00033784",189,57,19,38,132,16,20,35,19,9,11,22
"E00033785",128,33,10,23,95,12,12,14,25,2,8,22
"E00033786",140,17,0,17,123,5,3,19,26,4,24,42
"E00033787",130,21,5,16,109,11,16,19,25,6,7,25
"E00033788",107,18,2,16,89,5,3,23,21,4,20,13
"E00033789",105,15,9,6,90,6,14,18,19,2,9,22
"E00033790",109,21,4,17,88,8,4,28,20,5,8,15
"E00033791",150,41,14,27,109,32,9,18,22,5,11,12
"E00033792",80,15,3,12,65,8,6,12,17,1,7,14
"E00033793",134,44,13,31,90,21,9,15,10,3,15,17
"E00033794",117,32,8,24,85,23,7,16,19,0,8,12
"E00033795",119,37,13,24,82,7,10,22,19,2,7,15
"E00033796",89,27,13,14,62,9,9,4,15,6,3,16
"E00033797",106,35,15,20,71,12,14,7,16,1,9,12
"E00033798",136,31,20,11,105,6,16,14,25,4,13,27
"E00033799",117,32,17,15,85,10,24,11,11,2,11,16
"E00033800",84,23,2,21,61,8,1,22,20,4,3,3
"E00033801",128,45,22,23,83,14,22,7,17,1,2,20
"E00033802",76,24,10,14,52,6,9,7,9,1,7,13
"E00033803",120,41,20,21,79,11,12,8,19,3,5,21
"E00033804",120,42,17,25,78,13,13,7,15,6,8,16
"E00033805",97,56,29,27,41,8,8,2,9,2,2,10
"E00033806",122,84,4,80,38,2,2,6,18,0,2,8
"E00033807",227,110,13,97,117,27,8,13,38,3,8,20
"E00033808",92,36,17,19,56,4,9,7,7,10,9,10
"E00033810",145,87,18,69,58,14,2,18,15,5,2,2
"E00033811",218,81,23,58,137,23,18,20,21,19,23,13
"E00033812",177,79,20,59,98,23,4,21,23,6,13,8
"E00033813",207,98,16,82,109,15,10,18,18,13,18,17
"E00033814",165,64,12,52,101,34,7,25,17,4,2,12
"E00033815",168,85,21,64,83,22,7,14,25,0,6,9
"E00033816",130,41,18,23,89,19,9,18,22,7,4,10
"E00033818",141,66,42,24,75,20,6,19,12,6,7,5
"E00033819",142,90,8,82,52,8,2,13,20,3,2,4
"E00033820",141,79,11,68,62,11,9,17,13,2,2,8
"E00033821",113,81,23,58,32,4,4,1,18,0,2,3
"E00033822",159,42,12,30,117,35,11,15,20,7,14,15
"E00033823",58,20,8,12,38,1,5,4,10,2,8,8
"E00033824",165,44,6,38,121,35,4,29,13,9,20,11
"E00033825",135,40,9,31,95,25,15,19,18,5,3,10
"E00033826",176,94,4,90,82,4,2,5,59,0,0,12
"E00033827",152,114,6,108,38,3,1,4,20,1,3,6
"E00033828",155,59,18,41,96,20,9,18,23,5,6,15
"E00033829",142,96,2,94,46,7,0,4,28,0,2,5
"E00033832",144,93,11,82,51,2,2,1,39,0,2,5
"E00033833",192,132,8,124,60,9,0,12,28,4,1,6
"E00033836",91,72,13,59,19,0,0,5,12,0,0,2
"E00033837",127,53,13,40,74,4,11,7,10,3,15,24
"E00033838",105,28,9,19,77,16,9,14,15,5,2,16
"E00033839",242,93,50,43,149,12,44,19,25,3,12,34
"E00033840",213,151,5,146,62,15,0,11,21,2,2,11
"E00033841",145,78,25,53,67,8,11,5,14,4,9,16
"E00033842",194,108,13,95,86,18,0,24,25,6,4,9
"E00033843",142,43,15,28,99,20,11,18,20,14,6,10
"E00033844",134,50,18,32,84,15,18,9,11,9,11,11
"E00033845",142,98,33,65,44,2,4,7,22,0,1,8
"E00033846",207,108,35,73,99,10,3,6,43,6,12,19
"E00033847",127,65,17,48,62,13,5,8,20,2,5,9
"E00033848",147,29,12,17,118,5,20,21,32,6,11,23
"E00033849",132,20,11,9,112,6,24,21,26,4,8,23
"E00033850",162,41,23,18,121,4,30,19,29,2,9,28
"E00033851",119,39,19,20,80,6,14,9,16,3,5,27
"E00033852",106,33,18,15,73,3,12,12,13,5,2,26
"E00033853",125,35,8,27,90,10,16,12,33,4,2,13
"E00033854",134,27,15,12,107,5,25,13,21,6,13,24
"E00033855",110,74,40,34,36,2,5,6,12,1,0,10
"E00033856",180,134,63,71,46,7,17,6,11,0,3,2
"E00033857",116,42,21,21,74,1,19,13,22,2,4,13
"E00033859",117,45,8,37,72,2,19,12,20,5,3,11
"E00033861",171,94,38,56,77,2,10,14,34,3,2,12
"E00033862",141,51,25,26,90,6,20,17,26,1,5,15
"E00033863",121,26,10,16,95,1,22,25,23,3,7,14
"E00033864",110,29,19,10,81,2,15,17,15,5,4,23
"E00033865",137,28,13,15,109,7,19,26,18,3,9,27
"E00033866",122,31,22,9,91,2,20,12,20,3,10,24
"E00033867",118,30,16,14,88,4,22,16,14,1,7,24
"E00033868",119,23,16,7,96,2,9,26,18,2,12,27
"E00033869",122,24,20,4,98,3,23,11,19,1,7,34
"E00033870",172,120,23,97,52,15,4,10,14,0,2,7
"E00033871",115,24,12,12,91,5,20,20,17,4,6,19
"E00033872",125,31,15,16,94,3,16,20,20,7,9,19
"E00033873",138,56,25,31,82,3,16,12,17,2,9,23
"E00033874",131,32,23,9,99,2,21,15,17,1,8,35
"E00033875",119,21,12,9,98,4,24,24,12,3,9,22
"E00033876",117,32,18,14,85,0,22,20,13,2,10,18
"E00033877",130,25,15,10,105,2,20,21,20,2,11,29
"E00033878",127,35,22,13,92,3,24,15,25,1,7,17
"E00033879",116,23,12,11,93,4,11,17,26,3,8,24
"E00033880",187,46,21,25,141,11,30,19,35,2,13,31
"E00033881",125,30,15,15,95,2,18,19,20,3,9,24
"E00033882",104,21,13,8,83,3,20,16,12,5,8,19
"E00033883",129,44,21,23,85,4,18,19,21,1,8,14
"E00033884",130,33,24,9,97,3,22,13,20,5,10,24
"E00033885",213,74,17,57,139,10,22,24,46,4,7,26
"E00033886",112,25,19,6,87,3,22,15,20,1,4,22
"E00033887",137,29,19,10,108,4,17,14,20,3,15,35
"E00033888",130,33,19,14,97,2,20,12,17,4,7,35
"E00033889",123,23,16,7,100,1,23,15,28,7,2,24
"E00033890",121,75,8,67,46,13,5,3,13,3,0,9
"E00033891",131,56,20,36,75,5,18,12,19,0,3,18
"E00033892",63,32,8,24,31,4,7,1,10,1,1,7
"E00033893",118,39,18,21,79,4,22,14,18,3,7,11
"E00033894",126,32,17,15,94,6,19,17,16,1,6,29
"E00033895",108,51,5,46,57,5,8,14,19,0,1,10
"E00033896",123,43,15,28,80,1,10,17,25,3,4,20
"E00033897",123,37,16,21,86,4,23,11,20,2,2,24
"E00033898",149,50,10,40,99,14,17,15,20,4,9,20
"E00033899",129,61,15,46,68,16,9,9,14,3,2,15
"E00033900",112,31,6,25,81,16,7,16,17,0,5,20
"E00033901",184,125,17,108,59,5,6,4,27,1,5,11
"E00033902",118,25,8,17,93,16,13,15,16,7,6,20
"E00033903",112,61,8,53,51,9,3,9,15,2,2,11
"E00033904",144,62,31,31,82,5,34,6,6,1,7,23
"E00033905",119,78,29,49,41,3,17,3,8,0,3,7
"E00033906",126,95,14,81,31,5,2,3,9,1,3,8
"E00033907",161,100,9,91,61,8,5,7,17,2,7,15
"E00033908",175,106,6,100,69,15,6,6,29,0,3,10
"E00033909",114,30,8,22,84,13,13,8,15,4,3,28
"E00033910",158,56,12,44,102,23,8,18,16,6,10,21
"E00033911",148,44,13,31,104,19,9,20,25,3,13,15
"E00033913",111,43,4,39,68,5,1,24,32,0,1,5
"E00033914",143,57,14,43,86,15,8,20,13,2,7,21
"E00033915",102,49,10,39,53,14,5,9,12,0,3,10
"E00033917",136,55,17,38,81,8,7,18,25,0,5,18
"E00033918",161,107,45,62,54,8,16,7,10,0,4,9
"E00033919",128,70,16,54,58,6,13,9,6,1,8,15
"E00033920",150,91,44,47,59,3,15,7,18,1,2,13
"E00033921",163,83,12,71,80,16,5,16,23,4,6,10
"E00033922",136,38,10,28,98,10,12,15,25,1,12,23
"E00033923",138,76,12,64,62,18,11,10,12,1,2,8
"E00033924",179,75,10,65,104,27,7,14,21,6,5,24
"E00033925",167,126,8,118,41,17,3,6,7,0,3,5
"E00033926",138,49,11,38,89,19,12,17,21,2,9,9
"E00033927",147,35,9,26,112,20,15,13,24,5,10,25
"E00033928",114,38,17,21,76,13,9,11,19,2,6,16
"E00033930",126,57,11,46,69,11,9,6,18,1,5,19
"E00033931",139,70,9,61,69,12,5,14,16,4,8,10
"E00033932",119,30,15,15,89,10,14,12,13,3,9,28
"E00033933",97,23,10,13,74,12,7,10,16,6,4,19
"E00033934",162,100,8,92,62,13,6,8,17,2,6,10
"E00033935",190,110,14,96,80,15,5,12,32,1,5,10
"E00033936",127,51,9,42,76,18,10,5,20,3,5,15
"E00033937",95,34,8,26,61,14,4,11,21,1,1,9
"E00033938",137,49,8,41,88,13,13,21,27,2,1,11
"E00033939",113,46,5,41,67,5,10,7,13,5,12,15
"E00033940",142,67,11,56,75,15,6,6,23,2,9,14
"E00033941",138,58,18,40,80,9,9,9,22,4,7,20
"E00033942",180,90,41,49,90,7,21,11,23,5,7,16
"E00033943",146,60,10,50,86,15,14,18,22,1,3,13
"E00033944",132,76,4,72,56,6,6,4,17,1,4,18
"E00033945",96,49,14,35,47,7,6,7,14,0,2,11
"E00033946",168,60,18,42,108,14,10,22,25,8,11,18
"E00033947",108,34,7,27,74,17,6,10,12,3,8,18
"E00033948",151,42,18,24,109,22,15,14,35,4,5,14
"E00033949",151,77,22,55,74,21,8,14,20,1,3,7
"E00033950",180,58,24,34,122,24,15,21,31,4,7,20
"E00033951",121,49,20,29,72,7,12,5,22,0,7,19
"E00033952",151,40,10,30,111,9,15,7,33,3,4,40
"E00033953",178,73,12,61,105,16,11,16,29,6,6,21
"E00033954",112,54,22,32,58,11,10,3,14,2,5,13
"E00033955",160,61,22,39,99,22,13,17,21,2,4,20
"E00033956",42,12,7,5,30,6,8,2,3,1,1,9
"E00033957",134,55,13,42,79,16,7,11,12,6,6,21
"E00033958",135,37,12,25,98,20,9,15,24,4,3,23
"E00033959",138,60,15,45,78,20,17,6,19,3,2,11
"E00033960",129,35,11,24,94,11,13,24,14,2,9,21
"E00033961",136,58,15,43,78,13,13,10,16,2,7,17
"E00033962",121,37,13,24,84,5,10,13,23,3,10,20
"E00033963",173,64,18,46,109,28,13,20,27,1,4,16
"E00033964",172,103,12,91,69,20,9,8,16,1,4,11
"E00033965",134,74,12,62,60,10,12,5,12,4,6,11
"E00033966",133,61,10,51,72,17,10,9,19,1,4,12
"E00033967",138,43,16,27,95,26,17,10,29,2,4,7
"E00033968",91,71,8,63,20,1,4,3,3,2,4,3
"E00033969",113,46,12,34,67,6,7,9,18,0,8,19
"E00033970",146,76,18,58,70,4,20,15,13,3,6,9
"E00033971",77,24,10,14,53,3,9,10,13,1,6,11
"E00033972",135,78,16,62,57,7,13,16,7,1,5,8
"E00033973",84,28,10,18,56,9,13,7,10,1,3,13
"E00033974",134,66,18,48,68,9,8,8,25,3,3,12
"E00033975",174,79,16,63,95,22,11,15,22,1,3,21
"E00033976",114,64,18,46,50,5,4,7,18,2,4,10
"E00033977",78,40,18,22,38,5,6,3,9,1,5,9
"E00033978",116,89,22,67,27,0,10,2,6,2,1,6
"E00033979",72,44,25,19,28,7,4,3,4,0,0,10
"E00033980",114,41,18,23,73,13,14,7,20,0,4,15
"E00033981",90,52,35,17,38,6,10,2,12,0,0,8
"E00033982",43,13,8,5,30,4,5,10,3,0,0,8
"E00033983",110,44,8,36,66,17,5,9,17,2,4,12
"E00033984",102,33,8,25,69,6,16,9,13,2,6,17
"E00033985",110,55,12,43,55,15,6,7,14,2,2,9
"E00033986",108,31,15,16,77,7,11,16,18,2,5,18
"E00033987",133,69,14,55,64,12,6,13,15,1,3,14
"E00033988",119,46,7,39,73,13,7,8,24,2,5,14
"E00033989",115,52,8,44,63,13,5,7,20,2,5,11
"E00033990",120,34,8,26,86,15,2,17,18,5,9,20
"E00033991",117,30,12,18,87,11,14,17,18,4,2,21
"E00033992",129,53,19,34,76,6,21,13,14,1,5,16
"E00033993",208,98,29,69,110,18,12,23,29,5,9,14
"E00033994",132,24,10,14,108,27,7,19,15,3,15,22
"E00033995",109,28,11,17,81,12,13,10,20,2,4,20
"E00033996",117,19,8,11,98,17,11,13,30,4,3,20
"E00033997",147,48,16,32,99,14,11,16,24,3,14,17
"E00033998",122,33,18,15,89,12,21,13,19,3,8,13
"E00033999",118,34,11,23,84,22,8,9,12,1,13,19
"E00034000",117,33,15,18,84,13,14,9,12,4,10,22
"E00034001",147,60,21,39,87,8,16,17,28,3,6,9
"E00034002",107,35,20,15,72,6,25,9,11,5,4,12
"E00034003",91,29,10,19,62,9,6,16,10,2,8,11
"E00034004",96,33,14,19,63,12,15,6,12,0,3,15
"E00034005",131,41,25,16,90,7,24,15,16,4,7,17
"E00034006",121,45,25,20,76,3,16,17,14,0,6,20
"E00034007",97,37,18,19,60,5,12,7,16,1,7,12
"E00034008",120,37,14,23,83,10,15,6,22,0,7,23
"E00034009",112,46,31,15,66,6,16,5,13,6,5,15
"E00034010",108,56,38,18,52,4,14,4,12,1,6,11
"E00034011",141,34,6,28,107,9,7,28,32,4,8,19
"E00034012",111,20,8,12,91,16,10,8,26,2,7,22
"E00034013",128,57,12,45,71,9,10,8,16,1,5,22
"E00034014",111,42,29,13,69,4,23,7,9,1,7,18
"E00034015",110,32,18,14,78,9,14,15,15,3,8,14
"E00034016",113,30,12,18,83,14,19,9,19,0,7,15
"E00034017",123,23,9,14,100,13,14,10,21,2,14,26
"E00034019",131,54,13,41,77,10,10,17,17,3,7,13
"E00034020",125,28,8,20,97,16,11,19,22,2,10,17
"E00034021",120,32,17,15,88,8,11,20,19,3,10,17
"E00034022",152,53,20,33,99,9,11,27,24,7,5,16
"E00034023",136,79,28,51,57,17,9,8,13,0,2,8
"E00034024",145,67,12,55,78,18,2,14,21,3,10,10
"E00034025",178,84,27,57,94,17,12,12,25,3,11,14
"E00034026",129,46,6,40,83,21,10,11,21,1,6,13
"E00034027",108,40,7,33,68,18,6,10,19,3,3,9
"E00034028",164,87,22,65,77,19,9,13,23,1,8,4
"E00034029",177,73,21,52,104,15,9,19,30,7,7,17
"E00034030",123,39,15,24,84,18,8,18,23,1,4,12
"E00034031",106,45,10,35,61,5,8,10,12,2,7,17
"E00034032",120,32,20,12,88,5,11,12,18,1,16,25
"E00034033",98,19,9,10,79,10,12,14,17,2,7,17
"E00034034",132,50,15,35,82,10,11,9,17,3,14,18
"E00034035",127,35,11,24,92,14,15,9,21,4,9,20
"E00034036",120,22,13,9,98,8,14,12,19,3,9,33
"E00034037",132,37,14,23,95,6,18,24,11,2,10,24
"E00034038",136,41,11,30,95,9,13,12,23,3,9,26
"E00034039",143,54,22,32,89,6,14,13,29,2,5,20
"E00034040",108,24,7,17,84,8,13,14,20,4,5,20
"E00034041",129,39,24,15,90,6,17,13,18,5,9,22
"E00034042",135,44,20,24,91,15,14,15,18,3,7,19
"E00034043",159,89,32,57,70,6,5,16,15,5,10,13
"E00034044",130,33,15,18,97,12,12,15,19,2,17,20
"E00034045",152,57,20,37,95,16,15,17,22,5,7,13
"E00034046",133,52,15,37,81,11,14,14,18,2,7,15
"E00034047",129,48,19,29,81,9,11,20,21,4,5,11
"E00034048",117,39,23,16,78,2,16,14,20,4,4,18
"E00034049",130,44,20,24,86,9,10,15,30,7,3,12
"E00034050",135,40,8,32,95,13,11,23,25,3,5,15
"E00034051",106,44,20,24,62,12,4,11,26,1,0,8
"E00034052",119,37,11,26,82,14,7,21,23,2,5,10
"E00034053",157,65,6,59,92,13,9,20,18,4,13,15
"E00034054",133,37,17,20,96,11,10,25,21,1,7,21
"E00034055",162,88,10,78,74,10,3,12,17,2,11,19
"E00034056",139,71,18,53,68,21,10,10,20,1,2,4
"E00034057",112,42,11,31,70,20,7,20,12,1,2,8
"E00034058",152,81,16,65,71,13,7,8,25,2,5,11
"E00034059",187,60,18,42,127,27,19,21,27,3,12,18
"E00034061",142,40,9,31,102,14,10,24,22,0,9,23
"E00034062",190,75,13,62,115,10,9,9,18,5,7,57
"E00034063",145,35,11,24,110,1,1,8,22,5,2,71
"E00034064",119,17,3,14,102,0,6,7,12,0,2,75
"E00034065",126,49,18,31,77,1,17,13,12,3,8,23
"E00034066",143,67,22,45,76,11,16,8,25,0,4,12
"E00034067",131,41,13,28,90,13,8,12,26,4,7,20
"E00034068",144,70,13,57,74,14,8,6,20,5,2,19
"E00034069",167,62,11,51,105,11,6,9,19,5,4,51
"E00034070",157,58,8,50,99,22,4,13,26,6,6,22
"E00034071",182,78,18,60,104,18,5,19,31,2,3,26
"E00034072",151,78,30,48,73,13,6,12,19,0,6,17
"E00034073",101,32,5,27,69,9,5,5,15,2,3,30
"E00034074",171,67,13,54,104,27,6,17,38,1,3,12
"E00034075",152,82,18,64,70,22,9,8,19,4,3,5
"E00034076",143,63,16,47,80,14,1,11,26,6,0,22
"E00034077",147,75,23,52,72,25,6,8,26,0,1,6
"E00034078",140,69,17,52,71,15,7,12,22,0,5,10
"E00034079",162,80,13,67,82,18,4,13,35,1,1,10
"E00034080",113,35,5,30,78,9,11,7,29,0,3,19
"E00034081",200,101,33,68,99,15,6,4,46,4,5,19
"E00034082",117,47,16,31,70,10,12,11,26,3,1,7
"E00034083",107,29,6,23,78,11,5,11,21,1,6,23
"E00034084",105,37,10,27,68,11,3,9,8,4,7,26
"E00034085",143,58,11,47,85,22,5,10,37,1,2,8
"E00034086",61,21,7,14,40,6,2,4,5,7,6,10
"E00034087",91,20,9,11,71,9,3,1,12,1,4,41
"E00034088",161,73,13,60,88,22,4,14,32,1,2,13
"E00034089",99,10,6,4,89,7,5,5,21,3,6,42
"E00034090",114,34,17,17,80,6,3,6,14,4,6,41
"E00034091",73,12,7,5,61,3,3,7,9,2,5,32
"E00034092",84,22,7,15,62,5,3,6,9,0,3,36
"E00034093",158,66,8,58,92,3,7,9,18,2,7,46
"E00034094",141,29,11,18,112,7,10,7,22,2,5,59
"E00034095",134,58,18,40,76,8,8,10,34,0,2,14
"E00034096",126,36,13,23,90,3,7,4,20,0,6,50
"E00034097",109,18,7,11,91,2,11,4,15,2,8,49
"E00034098",125,36,15,21,89,4,7,3,20,2,6,47
"E00034099",102,32,5,27,70,0,8,6,10,1,2,43
"E00034100",150,56,13,43,94,9,5,19,34,4,2,21
"E00034101",152,71,20,51,81,14,10,9,29,2,3,14
"E00034102",138,58,13,45,80,23,11,12,19,0,4,11
"E00034104",153,57,14,43,96,16,12,13,29,1,6,19
"E00034105",150,65,13,52,85,9,6,10,22,7,5,26
"E00034106",86,23,7,16,63,4,8,8,18,4,4,17
"E00034107",128,30,15,15,98,11,8,10,27,3,3,36
"E00034108",121,77,39,38,44,16,5,5,10,0,1,7
"E00034109",102,45,13,32,57,14,3,4,24,5,2,5
"E00034110",143,46,9,37,97,9,10,15,34,1,7,21
"E00034111",121,47,15,32,74,15,10,14,14,1,6,14
"E00034113",116,28,12,16,88,13,9,15,16,1,13,21
"E00034114",123,30,12,18,93,10,19,13,12,3,11,25
"E00034115",113,33,15,18,80,8,11,18,12,3,11,17
"E00034116",153,42,12,30,111,38,14,9,20,5,3,22
"E00034117",124,39,16,23,85,25,9,5,19,0,4,23
"E00034118",92,28,11,17,64,14,3,11,17,1,8,10
"E00034119",124,34,20,14,90,13,14,10,22,2,7,22
"E00034120",103,22,16,6,81,14,8,10,16,4,8,21
"E00034121",117,25,8,17,92,15,14,18,21,2,3,19
"E00034122",128,30,14,16,98,21,20,9,14,5,7,22
"E00034123",137,39,9,30,98,26,7,16,17,6,14,12
"E00034124",127,31,13,18,96,24,17,7,12,6,12,18
"E00034125",125,38,11,27,87,22,12,15,15,2,5,16
"E00034126",148,35,10,25,113,10,19,17,24,6,10,27
"E00034127",126,27,8,19,99,9,14,13,20,8,14,21
"E00034130",117,31,13,18,86,14,11,13,14,2,6,26
"E00034131",152,37,10,27,115,13,19,16,25,2,8,32
"E00034132",91,42,11,31,49,8,10,9,6,0,7,9
"E00034133",101,34,16,18,67,13,4,10,9,4,5,22
"E00034134",133,46,18,28,87,13,12,9,23,4,9,17
"E00034135",117,60,16,44,57,9,6,14,12,0,5,11
"E00034136",136,41,18,23,95,14,11,15,17,2,14,22
"E00034137",108,32,13,19,76,20,9,12,14,3,6,12
"E00034138",129,35,13,22,94,29,8,10,21,4,7,15
"E00034139",118,23,12,11,95,10,22,14,14,0,7,28
"E00034140",98,29,15,14,69,6,13,7,11,1,8,23
"E00034141",111,39,25,14,72,23,17,11,11,1,1,8
"E00034142",146,30,19,11,116,19,15,16,25,4,12,25
"E00034143",123,26,13,13,97,6,20,13,20,3,11,24
"E00034144",136,37,19,18,99,15,13,13,12,4,15,27
"E00034145",106,37,13,24,69,10,15,12,10,6,3,13
"E00034146",120,26,14,12,94,27,14,11,16,7,7,12
"E00034147",106,38,22,16,68,10,10,10,14,4,5,15
"E00034148",149,31,21,10,118,38,6,19,16,11,11,17
"E00034149",118,44,20,24,74,17,9,9,9,3,11,16
"E00034150",92,35,19,16,57,9,7,9,11,2,5,14
"E00034151",119,26,17,9,93,21,15,16,13,4,8,16
"E00034152",127,43,21,22,84,11,11,10,21,2,13,16
"E00034153",133,44,16,28,89,25,13,14,14,5,4,14
"E00034154",140,45,20,25,95,12,16,12,21,3,6,25
"E00034155",148,48,18,30,100,19,9,18,14,9,15,16
"E00034156",104,40,21,19,64,18,3,17,10,5,6,5
"E00034157",133,47,18,29,86,16,14,16,19,1,7,13
"E00034158",140,46,25,21,94,12,14,12,22,0,10,24
"E00034159",121,40,11,29,81,3,13,23,15,4,4,19
"E00034160",111,26,16,10,85,4,19,12,22,5,4,19
"E00034161",131,54,8,46,77,17,13,6,19,2,6,14
"E00034162",143,49,9,40,94,17,14,13,17,4,11,18
"E00034163",118,48,24,24,70,15,7,11,17,2,4,14
"E00034164",158,66,23,43,92,26,12,12,15,1,10,16
"E00034165",93,17,4,13,76,22,8,10,8,11,5,12
"E00034167",194,77,25,52,117,23,17,18,34,5,3,17
"E00034168",127,25,9,16,102,9,18,14,22,4,11,24
"E00034169",152,94,8,86,58,3,5,9,13,3,2,23
"E00034170",119,37,14,23,82,4,12,12,20,2,12,20
"E00034171",113,50,22,28,63,4,11,9,12,2,5,20
"E00034172",127,42,12,30,85,14,13,17,19,1,5,16
"E00034173",122,57,13,44,65,12,6,11,21,5,2,8
"E00034174",111,38,14,24,73,9,10,14,20,4,6,10
"E00034175",116,46,19,27,70,11,10,10,16,2,6,15
"E00034176",81,39,7,32,42,8,4,8,11,2,4,5
"E00034177",134,59,25,34,75,12,13,9,20,1,5,15
"E00034178",160,74,14,60,86,14,12,17,26,0,2,15
"E00034180",153,42,8,34,111,22,14,26,23,1,3,22
"E00034182",72,40,18,22,32,6,3,3,10,1,3,6
"E00034184",121,47,14,33,74,16,4,25,18,0,4,7
"E00034185",117,48,27,21,69,11,12,6,19,3,4,14
"E00034187",137,96,17,79,41,2,8,7,10,3,5,6
"E00034188",142,47,21,26,95,22,9,11,18,2,12,21
"E00034189",119,40,16,24,79,14,8,12,16,2,5,22
"E00034190",103,30,19,11,73,15,8,15,17,2,10,6
"E00034191",110,41,17,24,69,8,11,10,18,3,7,12
"E00034192",152,41,16,25,111,22,16,17,27,3,5,21
"E00034193",125,45,17,28,80,10,15,18,11,2,7,17
"E00034194",105,26,11,15,79,12,11,17,22,0,3,14
"E00034195",106,42,8,34,64,9,10,11,13,2,10,9
"E00034196",141,43,16,27,98,14,17,20,19,4,8,16
"E00034197",135,42,14,28,93,11,18,12,20,1,11,20
"E00034199",130,53,22,31,77,16,8,13,6,1,14,19
"E00034200",128,51,21,30,77,13,8,4,12,1,5,34
"E00034201",157,102,17,85,55,6,5,4,24,1,5,10
"E00034202",124,34,24,10,90,12,23,11,17,2,8,17
"E00034203",173,66,18,48,107,13,8,8,28,2,3,45
"E00034208",156,109,42,67,47,4,11,7,11,4,4,6
"E00034209",115,86,17,69,29,3,4,3,8,0,0,11
"E00034211",126,63,15,48,63,4,4,5,24,0,8,18
"E00034212",141,81,9,72,60,10,2,6,20,1,3,18
"E00034213",203,89,48,41,114,6,26,18,21,2,11,30
"E00034215",50,18,3,15,32,3,3,3,6,1,6,10
"E00034216",205,61,21,40,144,26,16,29,53,4,5,11
"E00034219",142,70,16,54,72,16,10,12,20,2,2,10
"E00034221",128,45,21,24,83,12,26,6,10,2,8,19
"E00034222",202,122,16,106,80,3,11,9,27,0,3,27
"E00034223",126,58,22,36,68,5,13,4,22,1,2,21
"E00034224",137,35,13,22,102,8,8,8,17,4,6,51
"E00034225",140,44,8,36,96,10,19,7,16,2,4,38
"E00034227",128,29,12,17,99,7,6,7,19,2,3,55
"E00034228",149,46,16,30,103,4,10,8,11,0,5,65
"E00034230",150,27,11,16,123,10,7,6,30,2,5,63
"E00034231",156,71,18,53,85,6,8,8,11,1,4,47
"E00034234",147,38,10,28,109,31,12,12,21,2,11,20
"E00034235",127,25,10,15,102,23,8,22,19,1,10,19
"E00034236",144,64,15,49,80,13,12,5,21,2,7,20
"E00034237",133,45,17,28,88,16,9,12,20,4,6,21
"E00034238",53,9,4,5,44,4,6,7,13,2,4,8
"E00034239",144,39,7,32,105,29,13,19,20,2,5,17
"E00034240",134,46,7,39,88,19,19,12,18,2,5,13
"E00034241",127,40,9,31,87,17,8,14,22,1,9,16
"E00034242",115,39,18,21,76,11,17,16,8,5,5,14
"E00034243",172,36,8,28,136,44,15,20,25,4,7,21
"E00034244",117,27,11,16,90,15,10,19,15,4,12,15
"E00034245",128,42,16,26,86,19,12,11,19,3,5,17
"E00034246",121,38,16,22,83,24,9,12,15,2,6,15
"E00034247",126,51,25,26,75,17,14,7,18,4,7,8
"E00034248",116,65,31,34,51,8,12,8,10,1,3,9
"E00034249",147,85,34,51,62,21,2,10,10,5,6,8
"E00034250",168,51,13,38,117,38,10,18,20,3,6,22
"E00034251",143,64,24,40,79,10,9,7,32,1,5,15
"E00034252",183,53,18,35,130,26,11,29,28,2,16,18
"E00034253",168,57,12,45,111,29,7,18,28,1,15,13
"E00034254",144,50,20,30,94,28,9,14,21,5,4,13
"E00034255",136,36,14,22,100,23,18,17,18,4,6,14
"E00034256",139,38,16,22,101,24,15,18,15,3,12,14
"E00034257",150,70,18,52,80,14,13,10,17,1,5,20
"E00034258",133,35,11,24,98,21,13,12,21,7,9,15
"E00034259",131,45,8,37,86,18,7,22,16,4,8,11
"E00034260",117,45,22,23,72,22,9,10,14,4,6,7
"E00034261",108,22,10,12,86,13,10,16,17,5,8,17
"E00034262",121,41,13,28,80,4,7,17,15,5,8,24
"E00034263",122,69,23,46,53,10,2,6,15,0,10,10
"E00034264",140,47,11,36,93,23,10,11,19,1,8,21
"E00034265",238,68,23,45,170,17,25,21,52,5,13,37
"E00034266",140,56,19,37,84,12,14,13,20,3,7,15
"E00034267",99,22,11,11,77,3,13,8,13,1,15,24
"E00034268",207,85,19,66,122,25,12,19,27,4,15,20
"E00034269",109,60,8,52,49,7,12,9,10,4,2,5
"E00034270",145,68,9,59,77,5,8,9,16,4,7,28
"E00034271",118,25,11,14,93,15,13,7,23,4,9,22
"E00034272",168,101,19,82,67,11,4,13,12,1,3,23
"E00034273",95,65,13,52,30,5,2,3,10,1,1,8
"E00034274",124,81,3,78,43,2,1,7,15,3,1,14
"E00034275",117,25,8,17,92,5,27,8,13,2,8,29
"E00034276",127,35,8,27,92,12,16,9,19,2,12,22
"E00034277",104,27,13,14,77,9,14,10,16,1,4,23
"E00034278",127,38,9,29,89,7,6,12,24,5,7,28
"E00034279",189,133,11,122,56,1,0,9,31,0,5,10
"E00034280",122,107,25,82,15,2,1,0,9,0,0,3
"E00034281",109,83,4,79,26,0,0,4,10,0,1,11
"E00034282",180,68,11,57,112,22,9,17,25,3,4,32
"E00034283",157,53,16,37,104,14,10,20,23,2,13,22
"E00034284",123,59,14,45,64,4,12,8,11,4,9,16
"E00034285",141,59,23,36,82,8,18,11,12,4,9,20
"E00034286",121,27,13,14,94,14,16,14,13,2,13,22
"E00034287",116,37,12,25,79,17,12,10,13,5,9,13
"E00034288",128,36,15,21,92,13,8,12,26,2,11,20
"E00034289",109,35,9,26,74,20,9,8,23,1,2,11
"E00034290",115,29,10,19,86,17,7,18,15,4,5,20
"E00034291",100,39,11,28,61,16,6,12,11,2,5,9
"E00034292",112,30,5,25,82,18,10,9,22,2,8,13
"E00034293",136,54,24,30,82,18,11,11,30,2,5,5
"E00034294",234,74,8,66,160,25,15,41,31,9,8,31
"E00034295",103,41,7,34,62,14,3,12,13,4,3,13
"E00034296",136,41,9,32,95,19,22,17,18,2,6,11
"E00034297",129,60,20,40,69,9,10,12,13,3,4,18
"E00034298",148,51,14,37,97,12,20,18,22,2,3,20
"E00034299",120,51,13,38,69,21,9,10,7,1,4,17
"E00034300",105,43,25,18,62,8,13,11,8,2,9,11
"E00034301",136,72,8,64,64,11,8,8,17,5,6,9
"E00034302",117,34,10,24,83,13,5,11,28,2,10,14
"E00034303",138,69,24,45,69,10,10,7,24,2,4,12
"E00034304",133,77,11,66,56,6,8,8,15,2,7,10
"E00034305",132,57,21,36,75,10,20,7,11,0,7,20
"E00034306",140,58,10,48,82,13,13,13,18,5,13,7
"E00034307",120,68,6,62,52,6,4,8,14,0,7,13
"E00034308",151,46,12,34,105,13,12,24,22,2,10,22
"E00034309",120,48,14,34,72,16,6,9,17,2,5,17
"E00034310",149,64,7,57,85,17,4,10,20,3,10,21
"E00034311",132,53,12,41,79,14,7,13,19,1,3,22
"E00034312",144,55,12,43,89,18,8,16,28,0,5,14
"E00034313",140,52,12,40,88,13,6,23,16,7,5,18
"E00034314",119,47,12,35,72,18,5,14,16,1,6,12
"E00034315",168,125,87,38,43,5,19,2,9,0,1,7
"E00034316",111,37,15,22,74,5,12,14,15,3,5,20
"E00034317",185,81,18,63,104,28,18,15,15,7,8,13
"E00034318",106,20,12,8,86,14,18,9,14,2,11,18
"E00034319",161,82,34,48,79,14,19,13,17,3,7,6
"E00034320",94,51,19,32,43,6,7,8,7,1,5,9
"E00034321",47,14,8,6,33,9,4,5,9,0,4,2
"E00034322",127,48,27,21,79,9,11,10,20,0,13,16
"E00034323",142,59,20,39,83,14,12,12,16,2,8,19
"E00034324",128,40,20,20,88,13,18,11,19,3,9,15
"E00034325",126,53,19,34,73,12,15,10,15,4,4,13
"E00034326",119,40,24,16,79,0,24,9,20,0,6,20
"E00034327",108,27,11,16,81,8,8,12,19,2,7,25
"E00034328",125,31,16,15,94,2,9,25,21,1,17,19
"E00034329",112,41,13,28,71,1,16,6,16,3,6,23
"E00034330",103,34,20,14,69,4,22,13,11,2,3,14
"E00034331",116,34,22,12,82,10,18,7,18,3,8,18
"E00034332",146,48,11,37,98,17,16,19,20,3,3,20
"E00034333",138,53,27,26,85,8,14,9,22,3,4,25
"E00034334",140,96,63,33,44,9,11,4,13,0,2,5
"E00034335",95,26,13,13,69,14,10,11,10,2,13,9
"E00034336",106,35,17,18,71,7,16,8,19,2,4,15
"E00034337",140,27,10,17,113,5,16,25,32,2,3,30
"E00034338",107,20,8,12,87,8,15,24,18,0,5,17
"E00034339",120,26,14,12,94,4,20,16,23,3,11,17
"E00034340",93,20,9,11,73,3,14,14,18,1,6,17
"E00034341",136,37,22,15,99,4,21,18,18,6,6,26
"E00034342",94,21,7,14,73,4,16,19,18,1,2,13
"E00034343",103,23,14,9,80,5,10,17,26,1,6,15
"E00034344",105,20,7,13,85,4,11,17,15,1,10,27
"E00034345",83,13,3,10,70,2,8,18,17,1,11,13
"E00034346",76,52,35,17,24,3,6,0,9,0,1,5
"E00034347",122,61,25,36,61,5,11,12,19,1,3,10
"E00034348",111,33,20,13,78,8,22,6,18,2,7,15
"E00034349",119,32,17,15,87,26,9,6,24,1,5,16
"E00034350",139,77,51,26,62,17,11,8,12,1,6,7
"E00034351",179,93,15,78,86,18,7,13,27,3,4,14
"E00034352",114,31,13,18,83,14,14,13,19,2,7,14
"E00034353",121,47,24,23,74,13,11,11,13,0,11,15
"E00034354",150,84,15,69,66,19,7,4,18,1,2,15
"E00034355",172,93,27,66,79,17,13,6,15,3,7,18
"E00034356",78,43,11,32,35,9,7,3,11,0,1,4
"E00034358",173,74,22,52,99,15,9,12,34,4,10,15
"E00034359",111,42,7,35,69,8,6,8,22,1,10,14
"E00034360",80,37,6,31,43,8,8,8,7,2,1,9
"E00034361",101,41,26,15,60,7,15,5,18,0,4,11
"E00034362",127,80,43,37,47,7,11,1,18,1,2,7
"E00034363",129,54,15,39,75,10,15,11,21,0,4,14
"E00034364",124,66,20,46,58,8,9,5,19,0,3,14
"E00034365",152,67,17,50,85,14,10,12,25,0,6,18
"E00034366",179,89,37,52,90,12,12,17,27,3,5,14
"E00034368",136,56,19,37,80,17,7,11,28,0,2,15
"E00034369",125,49,9,40,76,13,8,10,23,0,6,16
"E00034371",119,44,18,26,75,19,15,6,14,1,3,17
"E00034372",117,35,18,17,82,18,14,8,13,1,6,22
"E00034373",122,82,19,63,40,4,10,1,9,1,8,7
"E00034374",121,41,21,20,80,9,14,14,19,2,4,18
"E00034375",159,26,15,11,133,4,23,28,24,1,13,40
"E00034376",132,37,21,16,95,5,15,21,16,2,13,23
"E00034377",127,31,12,19,96,4,7,25,28,2,9,21
"E00034378",130,32,14,18,98,13,8,21,26,3,5,22
"E00034379",161,65,19,46,96,8,11,20,26,4,8,19
"E00034380",128,23,8,15,105,6,17,25,23,3,10,21
"E00034381",222,56,24,32,166,11,22,44,45,9,12,23
"E00034382",163,59,11,48,104,15,16,19,20,5,3,26
"E00034383",158,32,12,20,126,10,10,28,20,7,16,35
"E00034384",127,36,7,29,91,17,12,14,18,4,14,12
"E00034386",203,115,12,103,88,11,7,8,23,4,11,24
"E00034387",153,100,13,87,53,7,9,9,19,3,3,3
"E00034388",137,60,34,26,77,24,12,8,17,1,5,10
"E00034389",93,30,16,14,63,3,18,10,15,0,6,11
"E00034390",143,40,10,30,103,16,14,7,20,4,13,29
"E00034391",153,38,13,25,115,11,10,26,26,2,11,29
"E00034392",124,24,8,16,100,12,14,21,19,8,6,20
"E00034393",111,30,18,12,81,7,18,18,14,2,2,20
"E00034394",127,38,7,31,89,10,12,16,24,0,6,21
"E00034395",119,48,9,39,71,17,8,13,21,2,3,7
"E00034396",136,47,16,31,89,14,9,17,15,4,3,27
"E00034397",134,43,19,24,91,8,8,17,27,4,8,19
"E00034398",139,59,11,48,80,5,13,13,26,2,6,15
"E00034399",161,68,20,48,93,10,18,16,24,3,3,19
"E00034400",138,66,20,46,72,11,7,13,20,4,2,15
"E00034401",167,83,24,59,84,14,4,21,14,1,9,21
"E00034402",129,52,14,38,77,5,13,13,19,1,7,19
"E00034403",145,64,14,50,81,0,14,16,20,1,7,23
"E00034404",126,43,11,32,83,9,8,26,18,2,8,12
"E00034405",148,40,10,30,108,10,14,15,31,4,4,30
"E00034406",151,61,17,44,90,9,7,23,21,1,10,19
"E00034409",156,46,23,23,110,7,20,17,21,2,15,28
"E00034410",130,35,10,25,95,12,14,17,21,6,6,19
"E00034412",176,98,11,87,78,11,3,13,27,2,4,18
"E00034413",117,29,11,18,88,19,20,10,20,1,3,15
"E00034414",110,23,13,10,87,12,11,22,16,1,5,20
"E00034415",176,89,14,75,87,11,8,11,30,3,7,17
"E00034416",138,28,17,11,110,10,22,14,20,9,7,28
"E00034417",122,35,6,29,87,29,8,12,16,4,3,15
"E00034418",158,25,9,16,133,19,11,35,26,4,13,25
"E00034419",113,38,11,27,75,11,10,9,24,1,2,18
"E00034420",106,35,16,19,71,3,12,10,22,3,5,16
"E00034421",132,48,17,31,84,9,6,18,22,1,5,23
"E00034422",138,51,22,29,87,10,20,15,18,1,6,17
"E00034424",118,39,24,15,79,15,19,5,17,1,4,18
"E00034425",147,59,17,42,88,9,12,19,23,1,3,21
"E00034426",220,109,22,87,111,23,10,19,29,3,6,21
"E00034427",141,80,37,43,61,13,11,8,17,0,4,8
"E00034428",148,40,11,29,108,25,9,20,27,1,6,20
"E00034429",146,75,27,48,71,16,9,9,19,1,5,12
"E00034430",150,66,14,52,84,28,7,15,18,2,1,13
"E00034431",108,34,10,24,74,7,11,17,22,0,5,12
"E00034432",164,57,26,31,107,15,8,24,29,2,11,18
"E00034433",123,29,12,17,94,4,29,18,22,3,4,14
"E00034434",145,24,10,14,121,5,27,19,25,5,7,33
"E00034435",138,37,21,16,101,3,33,13,21,5,6,20
"E00034436",152,67,32,35,85,1,23,11,26,3,6,15
"E00034437",172,70,22,48,102,11,16,14,31,0,10,20
"E00034438",117,42,21,21,75,1,23,15,17,3,3,13
"E00034439",137,60,21,39,77,2,9,13,27,3,2,21
"E00034440",135,52,17,35,83,4,20,17,14,6,2,20
"E00034441",122,29,21,8,93,8,20,22,18,2,7,16
"E00034442",142,59,19,40,83,5,12,12,29,6,2,17
"E00034443",132,46,24,22,86,4,25,15,19,2,1,20
"E00034444",128,34,22,12,94,3,26,15,28,0,4,18
"E00034445",120,32,14,18,88,3,26,11,21,2,5,20
"E00034446",186,63,28,35,123,4,32,25,23,4,10,25
"E00034447",111,18,12,6,93,0,9,27,7,8,12,30
"E00034448",112,25,8,17,87,3,22,19,24,0,3,16
"E00034449",93,42,33,9,51,3,20,4,12,0,3,9
"E00034451",150,80,21,59,70,16,3,10,26,1,1,13
"E00034453",143,76,31,45,67,2,17,11,22,0,4,11
"E00034454",218,163,85,78,55,0,33,0,19,0,0,3
"E00034455",99,25,15,10,74,2,14,16,15,1,3,23
"E00034456",96,17,9,8,79,2,14,14,20,0,7,22
"E00034457",100,22,12,10,78,1,32,6,12,3,5,19
"E00034458",101,38,25,13,63,0,25,8,9,3,4,14
"E00034459",127,36,20,16,91,5,31,11,15,3,5,21
"E00034460",109,38,28,10,71,0,47,6,9,1,3,5
"E00034461",110,77,28,49,33,2,7,3,14,0,3,4
"E00034462",110,33,21,12,77,3,24,8,18,2,4,18
"E00034463",89,17,13,4,72,0,20,11,11,6,5,19
"E00034464",119,31,21,10,88,2,29,7,25,2,3,20
"E00034465",112,28,24,4,84,0,25,8,18,4,5,24
"E00034466",132,41,28,13,91,2,28,15,22,2,3,19
"E00034467",111,19,10,9,92,1,27,20,11,3,6,24
"E00034468",121,32,21,11,89,6,24,12,16,2,9,20
"E00034469",98,10,6,4,88,1,14,25,15,1,10,22
"E00034470",124,18,12,6,106,1,29,12,23,6,10,25
"E00034471",128,37,21,16,91,0,32,14,14,2,7,22
"E00034472",162,70,16,54,92,20,5,14,29,2,5,17
"E00034473",134,35,30,5,99,2,36,13,16,0,10,22
"E00034474",202,109,29,80,93,28,17,10,27,2,2,7
"E00034475",130,61,12,49,69,8,6,9,25,6,3,12
"E00034476",137,63,40,23,74,6,22,13,20,0,6,7
"E00034477",136,37,19,18,99,5,21,22,21,5,11,14
"E00034478",202,124,66,58,78,1,27,15,18,4,3,10
"E00034479",132,33,13,20,99,1,25,16,22,2,7,26
"E00034480",153,107,52,55,46,1,28,3,11,0,0,3
"E00034481",137,80,21,59,57,15,5,7,13,1,4,12
"E00034482",130,95,72,23,35,6,9,8,9,0,1,2
"E00034483",141,66,20,46,75,4,14,10,19,1,7,20
"E00034484",149,74,24,50,75,11,7,7,24,0,3,23
"E00034485",127,38,16,22,89,10,17,14,23,0,10,15
"E00165671",173,64,23,41,109,16,10,14,30,3,7,29
"E00165713",52,13,5,8,39,0,6,8,10,3,3,9
"E00165714",53,11,7,4,42,0,8,7,8,0,7,12
"E00165715",199,72,14,58,127,20,7,12,63,1,6,18
"E00165716",161,70,9,61,91,15,13,10,30,1,7,15
"E00165717",76,31,8,23,45,2,11,2,18,0,3,9
"E00165718",175,56,22,34,119,2,29,17,33,2,8,28
"E00165719",133,90,13,77,43,5,3,8,11,2,6,8
"E00165720",128,32,9,23,96,9,13,10,33,1,8,22
"E00165721",54,10,2,8,44,0,9,10,11,2,5,7
"E00165722",167,71,18,53,96,14,12,15,28,0,2,25
"E00165723",85,24,4,20,61,1,5,18,8,2,4,23
"E00165724",166,50,10,40,116,8,17,21,44,3,5,18
"E00165725",75,21,14,7,54,0,22,3,8,3,9,9
"E00165726",210,79,37,42,131,15,27,16,29,3,13,28
"E00165727",85,34,11,23,51,3,10,10,14,1,3,10
"E00165729",143,43,11,32,100,6,26,8,33,0,6,21
"E00165730",176,39,6,33,137,3,13,34,34,6,18,29
"E00165731",108,21,5,16,87,10,12,9,29,1,4,22
"E00165758",66,13,5,8,53,1,16,7,8,3,4,14
"E00165759",93,30,8,22,63,1,10,6,18,2,5,21
"E00165760",137,100,78,22,37,1,21,2,7,0,1,5
"E00165762",163,54,19,35,109,18,12,15,35,3,9,17
"E00165763",119,46,18,28,73,13,11,11,22,0,3,13
"E00176596",136,70,30,40,66,7,9,12,30,0,3,5
"E00176597",136,57,31,26,79,17,11,7,16,4,13,11
"E00176598",93,17,0,17,76,7,1,28,22,1,6,11
"E00176599",90,33,11,22,57,4,6,11,14,1,8,13
"E00176600",112,49,1,48,63,22,2,12,21,0,1,5
"E00176601",138,24,5,19,114,10,0,57,21,8,9,9
"E00176602",77,46,3,43,31,6,1,2,15,1,1,5
"E00176603",113,58,0,58,55,4,0,3,43,1,0,4
"E00176604",99,54,2,52,45,1,0,2,40,0,0,2
"E00176605",124,57,0,57,67,2,0,7,56,0,0,2
"E00176606",118,64,3,61,54,3,1,5,42,0,0,3
"E00176607",104,34,0,34,70,3,0,4,60,0,0,3
"E00176608",135,71,1,70,64,2,5,2,52,0,0,3
"E00176609",144,61,25,36,83,29,7,10,7,7,8,15
"E00176610",176,106,32,74,70,10,9,5,21,1,6,18
"E00176611",52,6,3,3,46,1,0,1,8,1,3,32
"E00176612",108,27,8,19,81,1,3,4,19,3,5,46
"E00176613",93,24,0,24,69,8,0,4,25,2,1,29
"E00176614",136,29,3,26,107,0,3,1,21,2,6,74
"E00176615",222,185,3,182,37,0,3,9,16,2,1,6
"E00176616",108,71,1,70,37,1,0,2,30,0,0,4
"E00176617",817,788,2,786,29,5,1,3,14,2,0,4
"E00176618",89,32,12,20,57,7,7,2,21,0,4,16
"E00176619",128,64,6,58,64,1,2,5,38,0,0,18
"E00176620",134,69,11,58,65,3,4,2,31,0,2,23
"E00176621",88,49,0,49,39,2,0,4,25,0,0,8
"E00176622",102,50,2,48,52,0,0,3,38,0,0,11
"E00176623",63,29,0,29,34,3,1,5,21,0,0,4
"E00176624",109,63,28,35,46,1,1,3,23,0,1,17
"E00176625",114,70,0,70,44,0,0,3,39,0,0,2
"E00176626",156,95,2,93,61,1,2,4,50,0,0,4
"E00176627",112,57,11,46,55,2,10,6,25,0,3,9
"E00176628",121,51,0,51,70,1,0,6,59,0,0,4
"E00176629",125,70,0,70,55,1,1,4,41,0,1,7
"E00176630",130,38,10,28,92,4,20,11,23,2,6,26
"E00176631",85,20,8,12,65,7,15,10,12,2,7,12
"E00176632",95,23,8,15,72,7,5,25,13,5,4,13
"E00176633",80,28,6,22,52,8,2,6,21,1,4,10
"E00176634",326,276,1,275,50,0,0,1,36,1,0,12
"E00176635",127,62,1,61,65,0,0,2,51,0,0,12
"E00176636",123,86,0,86,37,0,0,0,34,0,0,3
"E00176637",92,71,1,70,21,3,0,0,14,0,1,3
"E00176638",138,83,7,76,55,1,5,3,36,0,0,10
"E00176639",82,64,0,64,18,2,1,1,8,0,0,6
"E00176640",175,73,21,52,102,7,7,25,30,1,3,29
"E00176641",79,56,5,51,23,5,2,3,9,0,3,1
"E00176642",180,97,2,95,83,0,1,5,64,0,0,13
"E00176643",130,75,2,73,55,0,1,3,43,0,0,8
"E00176644",115,57,0,57,58,2,0,4,43,0,0,9
"E00176645",116,69,1,68,47,0,0,3,36,0,1,7
"E00176646",117,72,1,71,45,2,1,1,39,0,1,1
"E00176647",129,64,1,63,65,1,0,4,53,0,0,7
"E00176648",190,60,21,39,130,18,15,19,27,2,18,31
"E00176649",115,69,32,37,46,2,19,4,5,1,5,10
"E00176650",124,63,2,61,61,1,1,10,46,0,0,3
"E00176651",108,32,20,12,76,19,7,16,15,1,5,13
"E00176652",136,86,0,86,50,0,1,2,35,0,1,11
"E00176653",243,96,0,96,147,3,0,14,109,0,0,21
"E00176654",125,77,1,76,48,1,3,6,29,1,2,6
"E00176655",117,70,1,69,47,10,0,5,21,0,1,10
"E00176656",135,85,2,83,50,0,4,4,36,0,0,6
"E00176657",138,85,1,84,53,1,0,1,47,0,0,4
"E00176658",125,68,1,67,57,1,0,1,40,0,1,14
"E00176659",117,75,3,72,42,0,1,0,40,0,0,1
"E00176660",110,59,2,57,51,1,1,4,41,0,0,4
"E00176661",61,16,0,16,45,0,0,7,10,1,3,24
"E00176662",122,36,1,35,86,8,6,25,11,9,9,18
"E00176663",138,59,6,53,79,15,1,14,23,4,7,15
"E00176664",92,35,4,31,57,5,10,7,8,2,9,16
"E00176665",211,91,21,70,120,21,18,18,36,4,11,12
"E00176666",90,39,9,30,51,4,5,8,27,1,1,5
"E00176667",188,88,15,73,100,7,8,14,58,1,2,10
"E00176668",208,69,17,52,139,15,21,21,41,1,14,26
"E00176669",111,51,20,31,60,11,8,8,21,1,3,8
"E00176670",149,66,8,58,83,12,5,13,40,1,5,7
"E00176671",159,63,27,36,96,17,20,9,24,2,6,18
"E00176672",92,47,1,46,45,12,0,5,26,0,0,2
"E00176673",115,63,5,58,52,14,5,10,18,0,3,2
"E00176674",116,54,1,53,62,2,1,2,46,0,0,11
"E00176675",248,152,2,150,96,2,1,6,80,0,1,6
"E00176676",117,74,3,71,43,4,0,8,29,0,0,2
"E00176677",127,30,16,14,97,12,19,15,23,5,7,16
"E00176678",126,36,15,21,90,3,16,17,24,5,12,13
"E00176679",160,100,0,100,60,1,0,3,53,0,0,3
"E00176680",171,101,0,101,70,0,1,5,62,0,0,2
"E00176681",119,64,0,64,55,1,0,5,42,0,1,6
"E00176682",132,90,3,87,42,0,0,2,39,0,0,1
"E00176683",119,63,1,62,56,1,0,2,50,0,0,3
"E00176684",134,59,0,59,75,0,0,6,59,1,0,9
"E00176685",116,40,7,33,76,20,4,10,21,2,5,14
"E00176686",127,85,1,84,42,1,0,2,34,0,0,5
"E00176687",135,74,1,73,61,0,0,1,45,0,0,15
"E00176688",138,84,1,83,54,3,0,1,14,0,0,36
"E00176689",60,31,0,31,29,0,0,0,12,0,1,16
"E00176690",100,57,4,53,43,5,2,0,24,0,1,11
"E00176691",91,37,4,33,54,1,3,1,25,0,1,23
"E00176692",132,63,0,63,69,1,2,5,49,0,1,11
"E00176693",84,39,1,38,45,2,0,1,37,0,0,5
"E00176694",121,83,8,75,38,2,2,3,26,0,0,5
"E00176695",108,69,6,63,39,1,0,3,19,1,0,15
"E00176696",177,49,16,33,128,18,14,27,24,1,14,30
"E00176697",128,51,12,39,77,9,11,16,11,0,10,20
"E00176698",45,31,0,31,14,0,0,1,13,0,0,0
"E00176699",126,74,24,50,52,8,6,8,12,0,2,16
"E00176700",117,61,1,60,56,1,0,1,44,0,0,10
"E00176701",146,74,3,71,72,4,0,8,48,0,1,11
"E00176702",77,19,7,12,58,1,6,5,9,0,1,36
"E00176703",112,21,0,21,91,7,2,32,41,1,2,6
"E00176704",107,48,10,38,59,13,4,10,19,0,4,9
"E00176705",79,45,2,43,34,10,0,3,21,0,0,0
"E00176706",131,32,5,27,99,8,6,31,29,1,8,16
"E00176707",108,43,19,24,65,5,5,8,16,7,6,18
"E00176708",89,37,15,22,52,10,11,8,8,3,5,7
"E00176709",158,120,2,118,38,1,1,12,21,0,0,3
"E00176710",152,102,43,59,50,2,8,2,18,0,1,19
"E00176711",121,41,5,36,80,3,2,2,30,0,1,42
"E00176712",58,41,3,38,17,0,2,7,8,0,0,0
"E00176713",48,25,9,16,23,2,1,5,7,0,1,7
"E00176714",88,49,14,35,39,3,9,6,10,1,3,7
"E00176715",83,62,46,16,21,1,12,1,3,0,1,3
"E00176716",108,57,2,55,51,1,2,4,36,0,2,6
"E00176717",92,58,1,57,34,12,0,4,12,3,0,3
"E00176718",93,29,7,22,64,18,6,7,9,6,13,5
"E00176719",122,60,9,51,62,6,3,11,39,1,0,2
"E00176720",122,44,22,22,78,2,12,21,29,5,5,4
"E00176721",126,63,6,57,63,4,3,20,25,3,3,5
"E00176722",118,22,1,21,96,4,4,33,34,4,2,15
"E00176723",110,26,13,13,84,2,15,15,18,0,9,25
"E00176724",81,32,2,30,49,3,1,2,37,0,0,6
"E00176725",111,68,8,60,43,0,8,6,21,1,1,6
"E00176726",130,55,5,50,75,1,3,6,11,1,5,48
"E00176727",151,58,13,45,93,12,5,19,31,4,4,18
"E00176728",84,38,2,36,46,3,12,5,9,1,2,14
"E00176729",108,28,16,12,80,12,11,25,14,2,6,10
"E00176730",89,43,10,33,46,10,8,4,18,1,2,3
"E00176731",73,43,1,42,30,13,0,6,4,1,2,4
"E00176732",145,43,14,29,102,19,9,14,18,6,5,31
"E00176733",127,89,5,84,38,6,1,1,19,0,6,5
"E00176734",62,23,0,23,39,1,1,2,31,0,0,4
"E00176735",127,70,0,70,57,3,0,2,46,0,0,6
"E00176736",123,46,1,45,77,1,1,2,67,0,1,5
"E00176737",114,53,1,52,61,0,0,0,51,0,0,10
"E00176738",62,36,9,27,26,5,2,5,5,0,3,6
"E00176739",124,42,0,42,82,0,0,0,76,0,0,6
"E00176740",118,86,1,85,32,0,0,5,27,0,0,0
"E00176741",116,55,26,29,61,10,16,3,13,3,4,12
"E00176742",103,44,3,41,59,15,0,9,28,2,2,3
"E00176743",113,38,1,37,75,16,1,17,33,1,1,6
"E00176744",54,13,3,10,41,9,1,6,7,1,4,13
"E00176745",111,33,5,28,78,10,5,17,28,4,4,10
"E00176746",330,198,35,163,132,13,11,20,57,2,15,14
"E00176747",52,14,3,11,38,3,3,4,12,2,5,9
"E00176748",113,49,0,49,64,2,0,1,49,0,0,12
"E00176749",157,83,0,83,74,1,0,3,59,0,0,11
"E00176750",119,54,20,34,65,11,8,18,12,2,1,13
"E00176751",119,52,9,43,67,9,6,15,29,0,2,6
"E00176752",151,71,12,59,80,8,12,8,30,1,3,18
"E00176753",95,31,5,26,64,25,4,8,10,2,9,6
"E00176754",148,95,33,62,53,12,9,7,11,3,3,8
"E00176755",135,61,20,41,74,13,9,12,18,2,6,14
"E00176756",136,73,1,72,63,1,0,3,55,0,0,4
"E00176757",135,83,10,73,52,1,3,4,36,0,0,8
"E00176758",55,32,4,28,23,6,4,2,5,1,1,4
"E00176759",104,32,6,26,72,21,6,16,12,2,4,11
"E00176760",78,27,7,20,51,14,10,5,7,3,4,8
"E00176761",102,32,2,30,70,15,4,23,16,3,3,6
"E00176762",94,35,10,25,59,21,2,13,7,2,3,11
"E00176763",40,7,1,6,33,8,2,16,4,1,1,1
"E00176764",116,38,9,29,78,17,8,19,22,4,2,6
"E00176765",108,40,1,39,68,17,1,13,25,0,3,9
"E00176766",118,70,1,69,48,0,0,2,42,0,0,4
"E00176767",94,29,16,13,65,6,12,12,16,0,4,15
"E00176768",179,79,33,46,100,5,30,10,23,1,12,19
"E00176769",111,63,0,63,48,1,1,2,43,0,0,1
"E00176770",57,12,1,11,45,9,6,9,8,2,4,7
"E00176771",44,8,7,1,36,0,6,12,4,0,3,11
"E00176772",98,20,10,10,78,0,19,12,18,3,5,21
"E00176773",107,68,4,64,39,8,1,8,17,1,1,3
"E00176774",53,25,18,7,28,3,6,2,7,2,2,6
