"GeographyCode","QS114EW0001","QS114EW0002","QS114EW0003","QS114EW0004","QS114EW0005","QS114EW0006","QS114EW0007","QS114EW0008","QS114EW0009","QS114EW0010","QS114EW0011","QS114EW0012"
"E00032987",198,26,6,20,172,23,14,21,34,15,16,49
"E00032988",298,142,13,129,156,12,0,19,68,0,15,42
"E00032989",333,174,9,165,159,24,10,31,50,5,9,30
"E00032990",326,148,31,117,178,16,2,35,82,0,7,36
"E00032991",320,154,3,151,166,14,0,17,78,0,16,41
"E00032992",240,123,7,116,117,14,4,15,24,5,10,45
"E00032993",282,87,11,76,195,10,12,29,100,5,18,21
"E00032994",111,36,12,24,75,29,6,12,18,0,4,6
"E00032995",268,82,40,42,186,27,26,17,36,13,22,45
"E00032996",417,63,29,34,354,88,38,51,38,23,29,87
"E00032997",211,44,12,32,167,28,8,43,40,0,10,38
"E00032998",337,63,16,47,274,35,24,59,70,15,16,55
"E00032999",359,153,8,145,206,23,2,11,116,10,9,35
"E00033000",177,41,33,8,136,19,30,14,4,14,12,43
"E00033002",227,74,11,63,153,11,10,23,46,21,21,21
"E00033004",252,102,9,93,150,6,12,18,80,0,9,25
"E00033005",336,85,29,56,251,38,38,23,52,12,37,51
"E00033006",271,32,15,17,239,25,30,34,56,6,25,63
"E00033007",317,72,32,40,245,28,28,43,44,37,13,52
"E00033008",345,54,14,40,291,73,14,37,38,28,52,49
"E00033012",149,66,6,60,83,0,16,14,50,0,0,3
"E00033013",202,61,13,48,141,15,2,32,56,5,9,22
"E00033015",209,41,5,36,168,7,0,37,96,0,0,28
"E00033016",448,128,6,122,320,13,2,69,74,58,54,50
"E00033018",140,36,3,33,104,5,0,3,42,0,0,54
"E00033019",350,145,8,137,205,25,6,14,64,5,16,75
"E00033020",231,94,2,92,137,2,2,6,66,0,4,57
"E00033021",262,65,15,50,197,17,14,37,58,11,26,34
"E00033023",298,86,33,53,212,12,10,30,30,0,14,116
"E00033024",178,58,14,44,120,20,14,14,32,0,7,33
"E00033025",265,56,14,42,209,8,24,54,66,5,25,27
"E00033026",219,28,13,15,191,4,24,73,18,10,13,49
"E00033027",366,109,36,73,257,14,22,36,66,10,5,104
"E00033029",240,39,9,30,201,14,18,42,50,5,6,66
"E00033030",240,23,10,13,217,3,46,43,16,5,33,71
"E00033031",309,39,16,23,270,2,22,69,56,10,27,84
"E00033032",347,154,19,135,193,6,10,26,126,0,0,25
"E00033033",288,122,9,113,166,14,0,27,100,0,0,25
"E00033034",313,118,5,113,195,12,4,23,118,0,0,38
"E00033035",324,57,12,45,267,13,24,36,96,5,21,72
"E00033036",191,75,6,69,116,20,0,16,68,0,0,12
"E00033037",276,78,25,53,198,8,54,41,28,0,25,42
"E00033038",166,73,1,72,93,16,2,9,40,0,5,21
"E00033040",270,69,15,54,201,6,14,46,42,10,16,67
"E00033041",262,33,25,8,229,12,26,59,38,16,34,44
"E00033042",239,27,14,13,212,2,32,26,24,5,46,77
"E00033043",252,28,10,18,224,11,28,57,56,5,18,49
"E00033044",239,18,10,8,221,5,42,45,20,5,17,87
"E00033045",215,81,42,39,134,15,24,26,28,5,13,23
"E00033046",180,73,51,22,107,0,58,6,26,5,0,12
"E00033047",282,19,10,9,263,9,36,65,34,5,42,72
"E00033048",252,23,18,5,229,0,40,54,30,5,38,62
"E00033049",372,41,7,34,331,24,10,111,74,5,30,77
"E00033050",227,13,9,4,214,0,22,38,34,5,36,79
"E00033051",308,65,6,59,243,17,26,22,114,5,6,53
"E00033052",377,41,14,27,336,8,24,39,50,11,29,175
"E00033053",278,32,10,22,246,21,12,54,48,10,13,88
"E00033054",158,30,8,22,128,17,14,13,24,10,19,31
"E00033055",244,35,6,29,209,6,14,52,52,33,13,39
"E00033056",278,34,10,24,244,14,34,87,52,10,8,39
"E00033057",292,39,14,25,253,9,24,89,36,10,28,57
"E00033059",307,63,42,21,244,20,42,61,36,11,30,44
"E00033060",204,45,32,13,159,5,32,35,16,0,14,57
"E00033061",235,27,15,12,208,5,24,46,18,15,38,62
"E00033062",264,30,20,10,234,2,38,59,20,10,33,72
"E00033063",259,19,9,10,240,9,36,35,36,15,42,67
"E00033064",235,23,5,18,212,9,28,72,34,10,14,45
"E00033065",293,29,17,12,264,4,22,66,64,28,22,58
"E00033066",242,88,13,75,154,8,10,33,94,0,6,3
"E00033067",279,120,17,103,159,14,8,22,78,0,17,20
"E00033068",327,115,7,108,212,4,4,22,128,10,9,35
"E00033069",248,102,12,90,146,13,4,27,84,0,4,14
"E00033070",263,129,15,114,134,24,8,12,80,0,4,6
"E00033071",261,61,6,55,200,12,16,31,96,17,0,28
"E00033072",275,82,4,78,193,17,2,13,122,0,5,34
"E00033073",253,140,32,108,113,2,4,9,88,0,7,3
"E00033074",283,122,13,109,161,38,0,36,38,0,9,40
"E00033075",237,188,52,136,49,4,4,15,26,0,0,0
"E00033076",302,68,23,45,234,6,42,49,52,11,35,39
"E00033077",292,113,29,84,179,8,10,35,76,0,5,45
"E00033078",272,117,17,100,155,16,24,27,34,5,13,36
"E00033079",230,61,15,46,169,4,12,42,36,20,5,50
"E00033080",197,114,32,82,83,21,16,15,28,0,0,3
"E00033081",220,62,15,47,158,6,18,42,64,5,0,23
"E00033082",312,22,13,9,290,5,46,51,50,27,33,78
"E00033083",336,23,6,17,313,6,42,26,48,41,65,85
"E00033084",325,59,28,31,266,24,36,69,30,15,27,65
"E00033085",321,51,21,30,270,19,38,47,42,10,47,67
"E00033086",249,35,29,6,214,7,76,34,38,5,4,50
"E00033087",397,36,7,29,361,26,22,79,46,16,86,86
"E00033088",239,26,18,8,213,3,26,25,48,17,25,69
"E00033089",302,42,23,19,260,28,16,56,32,15,38,75
"E00033090",376,26,13,13,350,5,40,68,52,15,69,101
"E00033091",306,28,16,12,278,9,40,22,52,15,38,102
"E00033092",307,32,19,13,275,0,48,74,34,10,23,86
"E00033093",372,48,22,26,324,26,40,62,38,15,35,108
"E00033094",328,35,18,17,293,10,54,66,30,10,38,85
"E00033095",414,35,17,18,379,15,48,61,68,18,58,111
"E00033096",259,30,21,9,229,2,60,65,18,10,21,53
"E00033097",263,35,13,22,228,22,34,40,40,5,22,65
"E00033098",274,21,14,7,253,2,66,30,44,37,14,60
"E00033099",163,57,55,2,106,0,22,22,16,0,15,31
"E00033100",297,52,27,25,245,26,38,33,46,5,39,58
"E00033101",212,34,22,12,178,0,38,33,30,12,11,54
"E00033102",429,82,16,66,347,38,34,80,82,5,52,56
"E00033103",298,32,17,15,266,5,36,22,32,20,69,82
"E00033104",275,34,14,20,241,16,34,32,30,23,51,55
"E00033105",293,31,23,8,262,3,40,47,30,0,51,91
"E00033106",286,37,16,21,249,15,36,51,46,6,35,60
"E00033107",353,17,8,9,336,24,34,27,42,20,77,112
"E00033108",317,22,13,9,295,32,28,36,48,10,66,75
"E00033109",322,28,17,11,294,4,36,62,42,15,52,83
"E00033110",340,33,12,21,307,21,52,55,44,5,40,90
"E00033112",308,23,13,10,285,4,34,61,42,12,52,80
"E00033113",246,38,18,20,208,4,34,37,56,0,27,50
"E00033114",303,18,5,13,285,0,56,65,36,30,23,75
"E00033115",132,62,26,36,70,0,28,9,16,0,0,17
"E00033116",137,73,34,39,64,3,24,4,18,0,0,15
"E00033117",385,44,37,7,341,10,46,93,46,21,50,75
"E00033118",331,24,15,9,307,8,42,72,44,0,35,106
"E00033119",262,30,20,10,232,3,46,59,30,15,33,46
"E00033120",313,42,21,21,271,17,38,85,34,6,38,53
"E00033121",220,53,31,22,167,10,60,34,26,5,8,24
"E00033122",275,36,22,14,239,12,54,58,36,5,21,53
"E00033123",258,40,33,7,218,7,76,42,24,5,25,39
"E00033124",307,34,14,20,273,16,22,40,28,20,56,91
"E00033125",187,64,13,51,123,18,16,17,28,10,0,34
"E00033126",251,30,18,12,221,2,48,28,34,5,22,82
"E00033127",435,73,29,44,362,18,38,96,56,0,33,121
"E00033128",268,36,19,17,232,27,22,39,38,5,55,46
"E00033129",256,30,19,11,226,7,64,30,14,5,19,87
"E00033130",360,23,11,12,337,9,34,52,42,26,50,124
"E00033131",275,64,42,22,211,19,22,36,28,10,48,48
"E00033132",419,40,12,28,379,33,24,79,46,15,69,113
"E00033133",366,35,25,10,331,53,36,55,30,5,78,74
"E00033134",190,62,12,50,128,27,16,26,24,5,8,22
"E00033135",445,54,18,36,391,79,34,70,42,25,62,79
"E00033136",225,37,15,22,188,35,22,23,12,21,33,42
"E00033137",280,97,15,82,183,59,18,32,26,6,14,28
"E00033138",171,76,14,62,95,24,6,19,20,0,4,22
"E00033139",248,83,32,51,165,14,40,7,46,0,18,40
"E00033140",202,34,14,20,168,32,18,23,18,5,23,49
"E00033141",208,28,13,15,180,22,14,41,16,6,20,61
"E00033142",273,39,12,27,234,35,18,39,48,10,40,44
"E00033143",261,68,8,60,193,72,8,23,14,25,25,26
"E00033144",204,70,17,53,134,38,10,20,54,0,4,8
"E00033145",294,34,12,22,260,57,20,50,36,5,39,53
"E00033146",304,41,11,30,263,33,22,43,32,29,38,66
"E00033147",308,44,20,24,264,29,12,33,40,10,59,81
"E00033148",258,38,16,22,220,36,20,57,32,11,24,40
"E00033149",226,32,9,23,194,20,26,35,36,10,25,42
"E00033150",316,55,7,48,261,69,8,47,50,11,44,32
"E00033151",262,65,15,50,197,45,14,36,14,0,49,39
"E00033152",305,62,6,56,243,34,18,38,44,11,28,70
"E00033153",332,73,21,52,259,35,34,56,30,10,23,71
"E00033154",156,68,10,58,88,12,10,25,18,0,0,23
"E00033155",266,81,30,51,185,53,28,28,36,10,12,18
"E00033156",238,61,12,49,177,16,18,22,38,12,22,49
"E00033157",326,55,14,41,271,55,10,76,32,20,14,64
"E00033158",302,40,8,32,262,82,8,59,38,0,31,44
"E00033159",197,31,8,23,166,76,10,39,14,0,8,19
"E00033160",354,85,13,72,269,47,26,31,18,21,61,65
"E00033161",280,71,50,21,209,14,10,47,28,5,47,58
"E00033162",280,70,7,63,210,45,10,26,14,5,58,52
"E00033163",277,70,6,64,207,34,4,19,32,0,39,79
"E00033164",351,42,10,32,309,53,14,72,60,5,13,92
"E00033165",166,90,49,41,76,8,14,7,10,0,31,6
"E00033166",158,81,27,54,77,5,36,13,6,0,5,12
"E00033167",310,31,7,24,279,34,52,63,38,11,35,46
"E00033168",285,35,23,12,250,11,44,40,40,18,40,57
"E00033169",302,34,17,17,268,23,30,39,28,15,16,117
"E00033170",360,35,14,21,325,37,22,55,42,5,44,120
"E00033171",345,37,15,22,308,27,20,68,42,5,40,106
"E00033172",186,90,3,87,96,2,8,7,24,10,24,21
"E00033173",315,42,18,24,273,11,34,44,22,5,41,116
"E00033174",297,32,13,19,265,54,20,38,22,26,38,67
"E00033175",279,26,8,18,253,26,36,35,32,22,50,52
"E00033176",264,28,8,20,236,34,8,27,26,22,58,61
"E00033177",298,40,16,24,258,37,34,37,32,24,31,63
"E00033178",170,45,11,34,125,12,26,18,14,6,18,31
"E00033179",322,39,10,29,283,37,32,59,44,21,31,59
"E00033181",421,65,7,58,356,4,14,27,46,28,46,191
"E00033182",368,109,16,93,259,16,4,48,52,5,19,115
"E00033183",584,91,8,83,493,6,8,15,78,0,56,330
"E00033185",340,38,2,36,302,12,8,22,32,26,14,188
"E00033186",318,29,3,26,289,8,2,22,38,10,19,190
"E00033187",197,80,5,75,117,2,6,12,64,0,4,29
"E00033188",327,24,7,17,303,14,10,10,46,0,45,178
"E00033189",509,79,19,60,430,79,20,51,52,29,79,120
"E00033190",574,79,13,66,495,106,12,100,44,95,74,64
"E00033191",448,18,5,13,430,15,14,10,32,10,24,325
"E00033192",434,25,10,15,409,4,8,15,30,29,5,318
"E00033193",327,31,6,25,296,13,16,30,46,0,24,167
"E00033194",345,30,8,22,315,7,10,24,46,6,33,189
"E00033195",249,24,7,17,225,9,18,28,66,0,26,78
"E00033196",210,102,3,99,108,4,6,10,38,7,18,25
"E00033197",355,146,60,86,209,12,62,16,68,0,9,42
"E00033198",393,28,9,19,365,11,22,64,54,5,12,197
"E00033199",185,102,47,55,83,2,26,8,24,0,4,19
"E00033200",232,85,40,45,147,16,22,11,16,0,5,77
"E00033201",235,19,7,12,216,6,8,21,58,15,4,104
"E00033202",315,20,3,17,295,6,8,45,30,11,0,195
"E00033203",244,29,11,18,215,27,16,25,24,10,12,101
"E00033204",252,27,3,24,225,8,12,39,58,0,12,96
"E00033206",184,71,6,65,113,11,10,28,48,0,4,12
"E00033207",293,103,7,96,190,63,18,16,42,20,14,17
"E00033208",257,79,2,77,178,44,8,47,30,10,12,27
"E00033209",323,149,40,109,174,40,10,20,42,7,26,29
"E00033210",271,78,13,65,193,16,6,43,16,11,44,57
"E00033211",357,50,11,39,307,49,12,48,46,42,37,73
"E00033212",314,30,11,19,284,66,26,42,46,32,50,22
"E00033213",401,38,15,23,363,9,10,26,36,0,29,253
"E00033214",538,80,10,70,458,97,12,78,90,38,60,83
"E00033215",349,69,8,61,280,56,4,45,38,35,54,48
"E00033216",252,88,6,82,164,35,6,31,56,0,20,16
"E00033217",287,87,11,76,200,17,6,28,72,5,14,58
"E00033218",303,25,6,19,278,11,14,56,22,25,47,103
"E00033219",362,99,13,86,263,8,12,38,68,5,8,124
"E00033220",389,42,8,34,347,11,6,25,48,0,4,253
"E00033221",249,134,4,130,115,11,0,7,30,0,12,55
"E00033222",178,107,56,51,71,14,24,10,10,5,0,8
"E00033223",248,124,9,115,124,10,2,3,58,5,18,28
"E00033224",301,62,35,27,239,34,40,31,34,21,21,58
"E00033225",300,100,9,91,200,47,4,42,12,23,40,32
"E00033226",417,73,21,52,344,75,24,26,42,37,45,95
"E00033227",262,76,43,33,186,33,14,15,18,0,33,73
"E00033228",341,138,45,93,203,30,36,33,22,15,33,34
"E00033229",284,47,25,22,237,4,38,32,34,0,47,82
"E00033230",279,26,14,12,253,14,44,28,46,6,46,69
"E00033231",203,64,17,47,139,33,10,13,30,12,14,27
"E00033235",228,64,19,45,164,26,12,14,42,12,30,28
"E00033237",276,73,24,49,203,29,40,29,30,13,27,35
"E00033238",463,53,20,33,410,40,48,57,26,20,79,140
"E00033242",233,35,18,17,198,20,26,27,22,0,23,80
"E00033245",315,90,41,49,225,34,28,29,42,5,41,46
"E00033246",253,57,13,44,196,24,10,26,34,10,29,63
"E00033247",333,48,16,32,285,47,16,77,40,11,32,62
"E00033248",294,212,44,168,82,25,6,9,36,0,0,6
"E00033249",285,55,14,41,230,45,12,53,34,14,39,33
"E00033250",226,61,13,48,165,57,16,34,30,0,5,23
"E00033251",222,44,9,35,178,40,16,40,24,16,11,31
"E00033252",350,81,43,38,269,55,28,39,22,17,58,50
"E00033253",240,77,37,40,163,34,12,26,14,15,11,51
"E00033254",358,43,15,28,315,48,42,38,46,0,58,83
"E00033255",267,49,18,31,218,21,44,18,28,21,19,67
"E00033256",225,34,21,13,191,19,24,33,36,10,33,36
"E00033257",308,101,28,73,207,19,38,18,52,15,14,51
"E00033258",325,61,31,30,264,52,70,36,12,15,20,59
"E00033259",135,43,6,37,92,22,12,21,20,5,0,12
"E00033260",245,63,23,40,182,31,12,30,36,10,9,54
"E00033261",247,39,9,30,208,23,14,30,36,10,51,44
"E00033262",154,52,11,41,102,27,12,17,32,0,4,10
"E00033263",145,55,8,47,90,15,6,27,16,0,0,26
"E00033264",279,73,30,43,206,61,26,26,36,10,8,39
"E00033265",298,47,17,30,251,12,26,37,30,21,54,71
"E00033266",314,65,18,47,249,14,34,36,20,10,39,96
"E00033267",250,82,45,37,168,39,24,31,12,5,16,41
"E00033268",291,39,21,18,252,2,22,45,44,10,40,89
"E00033269",168,55,32,23,113,4,14,19,12,5,24,35
"E00033270",345,31,16,15,314,20,26,67,40,10,69,82
"E00033271",379,18,14,4,361,12,16,65,36,45,44,143
"E00033272",301,27,11,16,274,13,38,59,44,5,50,65
"E00033274",259,61,15,46,198,13,18,50,20,21,27,49
"E00033275",286,70,48,22,216,5,38,34,26,30,18,65
"E00033276",225,68,13,55,157,34,4,43,42,5,4,25
"E00033277",224,33,20,13,191,19,22,51,24,14,18,43
"E00033278",225,39,14,25,186,24,26,31,34,21,20,30
"E00033279",276,53,13,40,223,63,26,42,38,6,12,36
"E00033281",307,47,12,35,260,38,30,42,42,16,36,56
"E00033282",303,35,20,15,268,20,36,39,34,21,43,75
"E00033283",276,38,23,15,238,6,42,40,30,6,33,81
"E00033284",250,143,23,120,107,36,4,3,24,5,20,15
"E00033285",300,54,21,33,246,21,34,62,32,5,38,54
"E00033286",218,79,52,27,139,6,28,24,24,11,18,28
"E00033287",306,30,10,20,276,26,22,63,40,15,67,43
"E00033288",321,29,13,16,292,20,14,91,36,16,28,87
"E00033289",229,37,11,26,192,10,18,32,44,0,29,59
"E00033290",242,22,5,17,220,23,12,50,26,16,32,61
"E00033291",498,31,13,18,467,64,22,128,76,32,60,85
"E00033292",203,47,7,40,156,9,22,42,44,5,5,29
"E00033293",319,54,34,20,265,46,26,43,38,5,40,67
"E00033294",232,68,19,49,164,44,8,22,38,5,10,37
"E00033295",283,21,15,6,262,20,38,78,34,5,26,61
"E00033296",268,31,19,12,237,6,44,32,28,10,35,82
"E00033297",312,58,27,31,254,12,28,45,40,5,46,78
"E00033298",294,51,23,28,243,6,40,28,18,25,53,73
"E00033299",288,38,28,10,250,2,38,36,32,26,45,71
"E00033300",234,45,15,30,189,11,32,31,34,5,24,52
"E00033301",300,32,17,15,268,58,18,67,28,5,19,73
"E00033302",239,36,24,12,203,49,16,31,48,5,33,21
"E00033304",252,22,8,14,230,13,36,27,42,17,32,63
"E00033305",276,45,15,30,231,13,36,35,30,20,48,49
"E00033306",280,47,22,25,233,21,22,34,34,5,67,50
"E00033307",312,30,16,14,282,60,26,57,34,20,27,58
"E00033308",288,42,23,19,246,33,18,65,26,10,22,72
"E00033309",316,40,14,26,276,56,36,51,32,21,21,59
"E00033310",331,25,12,13,306,63,34,66,22,17,44,60
"E00033312",276,55,18,37,221,23,40,25,34,10,27,62
"E00033313",340,27,13,14,313,57,30,41,54,27,28,76
"E00033314",316,40,21,19,276,17,28,58,38,22,43,70
"E00033315",354,30,20,10,324,31,36,47,34,10,71,95
"E00033316",327,42,26,16,285,21,28,96,62,5,22,51
"E00033317",368,35,14,21,333,9,46,85,72,6,43,72
"E00033318",355,46,19,27,309,45,34,20,52,22,31,105
"E00033319",419,38,19,19,381,3,46,99,58,34,34,107
"E00033320",292,36,23,13,256,4,38,71,48,0,17,78
"E00033322",301,23,10,13,278,4,50,52,44,23,26,79
"E00033323",297,14,12,2,283,5,42,66,28,15,52,75
"E00033324",304,20,12,8,284,4,28,71,52,11,57,61
"E00033326",293,14,9,5,279,2,44,81,32,15,32,73
"E00033327",295,39,27,12,256,5,28,67,42,5,53,56
"E00033328",264,53,22,31,211,12,26,40,18,5,37,73
"E00033329",316,35,17,18,281,9,42,66,32,0,39,93
"E00033330",320,31,19,12,289,10,42,75,50,5,49,58
"E00033331",328,35,28,7,293,4,56,91,24,17,25,76
"E00033332",314,16,8,8,298,7,30,64,26,22,55,94
"E00033333",341,26,15,11,315,6,42,72,30,38,60,67
"E00033334",294,17,6,11,277,12,30,54,42,21,44,74
"E00033335",252,31,16,15,221,5,36,38,40,10,35,57
"E00033336",328,23,15,8,305,13,24,83,46,20,45,74
"E00033337",200,27,14,13,173,8,24,39,26,5,21,50
"E00033338",274,8,2,6,266,12,34,58,30,16,69,47
"E00033339",353,38,13,25,315,12,34,48,26,25,86,84
"E00033340",305,9,6,3,296,5,30,91,34,25,29,82
"E00033341",309,19,14,5,290,10,40,72,42,11,50,65
"E00033342",324,29,15,14,295,7,54,54,30,27,45,78
"E00033343",264,16,8,8,248,6,20,73,34,5,36,74
"E00033344",332,36,16,20,296,8,40,112,46,5,12,73
"E00033345",384,18,11,7,366,7,38,102,32,11,70,106
"E00033346",289,45,21,24,244,3,20,69,38,16,32,66
"E00033347",315,26,15,11,289,7,32,77,42,10,52,69
"E00033348",289,29,23,6,260,2,38,56,30,23,44,67
"E00033349",267,90,13,77,177,19,26,20,42,22,19,29
"E00033350",322,23,13,10,299,8,46,68,46,16,56,59
"E00033351",300,34,13,21,266,22,48,34,26,16,68,52
"E00033352",255,34,11,23,221,26,26,49,24,10,26,60
"E00033353",254,19,13,6,235,12,30,45,46,15,20,67
"E00033354",214,107,37,70,107,4,10,31,44,5,0,13
"E00033355",275,33,12,21,242,7,18,65,50,10,42,50
"E00033356",345,36,20,16,309,19,42,43,48,15,69,73
"E00033357",266,47,30,17,219,31,36,22,30,0,22,78
"E00033358",221,28,11,17,193,25,26,36,30,15,11,50
"E00033359",324,73,27,46,251,13,34,56,44,20,25,59
"E00033360",354,49,20,29,305,18,52,82,34,5,38,76
"E00033361",429,45,23,22,384,27,36,99,70,10,60,82
"E00033362",272,27,18,9,245,7,18,80,36,15,26,63
"E00033363",196,29,10,19,167,8,12,54,38,5,10,40
"E00033364",362,25,19,6,337,9,44,87,40,10,56,91
"E00033365",448,41,21,20,407,17,26,95,62,31,57,119
"E00033366",284,22,17,5,262,10,24,63,38,15,25,87
"E00033367",336,48,6,42,288,14,16,43,48,31,16,120
"E00033368",269,44,23,21,225,8,22,39,70,15,39,32
"E00033369",373,24,10,14,349,7,16,103,68,16,53,86
"E00033370",272,64,43,21,208,11,24,51,54,5,11,52
"E00033371",308,29,17,12,279,8,38,62,52,20,14,85
"E00033372",291,28,5,23,263,15,16,39,44,20,77,52
"E00033373",474,42,12,30,432,13,48,96,64,45,54,112
"E00033374",275,53,26,27,222,15,32,57,74,10,5,29
"E00033375",347,42,22,20,305,4,54,39,38,25,63,82
"E00033376",281,46,29,17,235,8,58,56,38,11,8,56
"E00033377",306,41,18,23,265,0,38,59,58,5,38,67
"E00033378",334,40,19,21,294,11,30,67,46,21,36,83
"E00033379",273,45,17,28,228,29,16,71,56,10,0,46
"E00033380",246,28,13,15,218,2,28,44,56,10,19,59
"E00033381",208,78,51,27,130,4,38,37,24,0,5,22
"E00033382",332,25,13,12,307,4,30,64,38,21,46,104
"E00033383",281,48,19,29,233,28,24,72,52,0,4,53
"E00033384",356,32,21,11,324,21,50,49,60,26,29,89
"E00033385",317,63,15,48,254,16,22,53,70,5,12,76
"E00033386",352,32,9,23,320,24,18,67,54,26,25,106
"E00033387",214,71,7,64,143,4,2,22,50,5,23,37
"E00033388",288,86,24,62,202,22,36,22,46,18,13,45
"E00033389",278,33,8,25,245,15,20,84,50,5,37,34
"E00033391",346,65,8,57,281,41,24,57,48,0,22,89
"E00033392",285,85,13,72,200,16,8,29,40,0,47,60
"E00033394",284,70,10,60,214,2,6,31,50,15,28,82
"E00033395",287,77,7,70,210,7,18,25,80,5,18,57
"E00033396",285,45,17,28,240,7,32,52,30,5,25,89
"E00033397",323,34,16,18,289,4,24,89,42,20,56,54
"E00033399",330,23,14,9,307,14,40,74,48,15,35,81
"E00033400",299,33,21,12,266,11,24,83,30,10,19,89
"E00033401",275,17,10,7,258,19,26,68,42,22,29,52
"E00033402",346,31,6,25,315,10,22,52,70,0,22,139
"E00033403",348,34,13,21,314,4,44,52,62,10,25,117
"E00033404",329,70,15,55,259,8,32,40,60,17,12,90
"E00033405",305,30,6,24,275,11,36,63,68,15,29,53
"E00033406",321,30,19,11,291,11,28,72,40,21,38,81
"E00033407",328,45,12,33,283,14,16,44,56,10,9,134
"E00033408",327,38,16,22,289,0,20,44,38,5,37,145
"E00033409",314,80,66,14,234,12,78,34,26,15,18,51
"E00033410",289,38,11,27,251,10,8,47,42,0,20,124
"E00033411",330,29,19,10,301,5,34,37,26,15,69,115
"E00033412",345,47,21,26,298,17,20,50,66,10,24,111
"E00033413",242,45,6,39,197,12,18,42,36,5,11,73
"E00033414",330,45,12,33,285,21,16,72,58,10,19,89
"E00033415",274,11,6,5,263,0,28,54,42,30,40,69
"E00033416",359,40,11,29,319,16,8,61,74,20,17,123
"E00033417",339,44,14,30,295,8,30,65,58,5,31,98
"E00033418",424,22,16,6,402,0,52,67,48,37,91,107
"E00033419",308,31,20,11,277,5,32,63,34,22,32,89
"E00033420",388,42,17,25,346,17,26,45,60,10,22,166
"E00033421",309,48,15,33,261,12,18,42,34,16,50,89
"E00033422",467,31,11,20,436,4,50,86,66,36,50,144
"E00033423",315,38,12,26,277,4,14,51,56,11,25,116
"E00033424",304,41,12,29,263,19,20,38,70,15,12,89
"E00033425",245,52,11,41,193,21,6,40,64,0,25,37
"E00033426",302,34,11,23,268,2,20,35,58,5,55,93
"E00033427",240,30,14,16,210,13,42,40,30,16,18,51
"E00033428",309,29,7,22,280,39,26,57,44,17,42,55
"E00033432",321,46,24,22,275,26,38,42,30,27,38,74
"E00033435",289,40,20,20,249,6,30,32,44,5,60,72
"E00033436",275,41,12,29,234,33,34,29,50,5,31,52
"E00033437",266,38,18,20,228,6,34,47,32,5,60,44
"E00033438",307,32,13,19,275,18,34,47,52,21,35,68
"E00033439",358,56,21,35,302,45,46,34,70,5,31,71
"E00033440",348,37,16,21,311,73,30,62,34,58,20,34
"E00033441",301,56,19,37,245,43,36,45,30,15,39,37
"E00033442",336,43,19,24,293,6,36,41,30,25,72,83
"E00033443",158,29,13,16,129,14,8,21,26,5,25,30
"E00033444",254,37,17,20,217,38,32,33,34,5,23,52
"E00033445",257,24,14,10,233,26,22,36,20,5,44,80
"E00033446",277,39,18,21,238,15,36,24,32,6,46,79
"E00033447",159,59,44,15,100,9,18,18,16,0,14,25
"E00033448",308,40,15,25,268,21,30,39,24,15,59,80
"E00033449",297,54,18,36,243,32,38,37,44,10,15,67
"E00033450",301,36,19,17,265,27,30,31,28,5,45,99
"E00033451",231,55,18,37,176,17,12,27,26,17,43,34
"E00033452",229,41,20,21,188,10,28,28,38,5,15,64
"E00033453",148,40,2,38,108,10,18,11,18,6,10,35
"E00033454",489,81,21,60,408,63,34,101,62,34,45,69
"E00033455",231,59,10,49,172,45,22,27,26,5,16,31
"E00033456",336,38,18,20,298,18,32,43,34,21,50,100
"E00033457",214,31,8,23,183,57,10,38,24,10,15,29
"E00033458",227,19,6,13,208,47,10,29,26,21,28,47
"E00033459",268,83,49,34,185,14,20,37,20,10,19,65
"E00033460",200,24,5,19,176,19,4,81,20,0,21,31
"E00033462",217,28,16,12,189,27,24,12,36,22,27,41
"E00033463",218,36,19,17,182,31,38,17,28,0,13,55
"E00033464",284,32,15,17,252,32,26,31,50,17,32,64
"E00033466",278,36,15,21,242,29,36,36,32,0,32,77
"E00033468",286,33,17,16,253,26,38,22,24,10,35,98
"E00033470",324,39,15,24,285,40,30,48,28,16,52,71
"E00033471",279,26,13,13,253,28,38,40,22,26,38,61
"E00033472",249,36,16,20,213,48,24,34,24,15,19,49
"E00033473",272,34,11,23,238,31,30,30,38,10,33,66
"E00033474",229,87,19,68,142,28,22,23,42,5,4,18
"E00033475",287,86,18,68,201,36,18,66,34,22,6,19
"E00033476",234,59,19,40,175,8,20,18,20,0,44,65
"E00033477",177,20,7,13,157,7,16,30,28,6,24,46
"E00033478",273,32,18,14,241,20,34,29,42,27,37,52
"E00033479",390,51,25,26,339,49,44,58,38,5,32,113
"E00033480",279,24,9,15,255,6,24,39,48,11,56,71
"E00033481",399,53,30,23,346,69,54,57,34,10,38,84
"E00033482",282,32,19,13,250,17,30,20,38,17,38,90
"E00033483",336,83,47,36,253,27,20,45,42,22,19,78
"E00033484",292,37,13,24,255,24,28,43,36,10,20,94
"E00033485",318,46,22,24,272,40,38,43,28,15,28,80
"E00033486",348,59,15,44,289,61,18,61,56,0,22,71
"E00033487",239,108,50,58,131,12,26,25,16,5,6,41
"E00033488",235,90,14,76,145,43,6,24,42,6,0,24
"E00033489",312,35,20,15,277,15,40,44,24,6,68,80
"E00033490",268,32,16,16,236,23,36,31,28,17,47,54
"E00033491",224,88,17,71,136,36,8,28,32,0,6,26
"E00033492",330,104,24,80,226,55,26,23,54,5,12,51
"E00033493",289,56,14,42,233,43,20,39,44,0,23,64
"E00033494",254,32,17,15,222,27,16,37,30,15,27,70
"E00033495",335,60,19,41,275,68,24,53,42,0,39,49
"E00033496",299,68,22,46,231,54,26,44,32,20,5,50
"E00033497",222,32,11,21,190,24,20,14,38,5,34,55
"E00033498",112,76,11,65,36,8,6,3,14,0,5,0
"E00033501",123,80,19,61,43,11,6,0,16,5,0,5
"E00033502",240,34,13,21,206,34,10,52,36,5,23,46
"E00033503",247,29,10,19,218,26,12,68,32,5,38,37
"E00033504",315,31,12,19,284,36,38,47,32,12,35,84
"E00033505",215,31,13,18,184,17,24,38,24,0,30,51
"E00033506",303,44,16,28,259,50,26,35,14,15,37,82
"E00033507",247,65,10,55,182,45,14,16,48,0,24,35
"E00033508",228,81,49,32,147,28,16,9,16,0,34,44
"E00033509",287,25,10,15,262,63,26,40,34,6,35,58
"E00033510",290,46,15,31,244,40,20,34,50,10,13,77
"E00033511",232,55,12,43,177,30,18,36,36,10,15,32
"E00033512",209,19,3,16,190,9,14,28,28,5,59,47
"E00033513",293,51,13,38,242,33,22,49,30,20,58,30
"E00033514",234,50,28,22,184,20,30,28,22,10,28,46
"E00033515",281,48,7,41,233,33,24,37,36,10,27,66
"E00033516",251,35,11,24,216,15,20,50,38,5,11,77
"E00033517",298,39,17,22,259,25,36,32,32,20,37,77
"E00033518",254,48,13,35,206,39,14,51,38,0,42,22
"E00033519",329,48,19,29,281,59,26,63,26,15,44,48
"E00033520",186,49,11,38,137,18,22,32,26,0,14,25
"E00033521",246,79,11,68,167,40,24,34,20,5,5,39
"E00033522",285,70,15,55,215,44,30,61,38,5,8,29
"E00033523",341,38,15,23,303,49,38,57,46,14,37,62
"E00033524",416,100,30,70,316,51,30,62,74,10,29,60
"E00033525",331,33,18,15,298,35,40,53,32,6,31,101
"E00033526",269,42,10,32,227,19,32,75,56,5,6,34
"E00033527",384,47,34,13,337,20,38,64,36,11,68,100
"E00033528",256,54,19,35,202,14,26,42,42,10,24,44
"E00033530",448,11,4,7,437,21,34,114,54,27,65,122
"E00033531",359,19,8,11,340,11,56,81,44,17,43,88
"E00033532",392,47,26,21,345,17,38,65,66,5,49,105
"E00033533",235,22,12,10,213,15,36,43,32,5,19,63
"E00033534",218,55,24,31,163,11,40,22,56,0,4,30
"E00033535",305,38,15,23,267,19,46,49,44,5,23,81
"E00033536",314,36,17,19,278,12,26,64,40,11,32,93
"E00033537",288,48,22,26,240,18,34,60,30,5,34,59
"E00033538",320,41,22,19,279,11,56,48,56,5,21,82
"E00033539",315,32,7,25,283,16,20,69,66,20,13,79
"E00033540",314,44,13,31,270,13,26,46,46,20,30,89
"E00033541",323,36,20,16,287,6,44,63,32,6,53,83
"E00033542",271,51,17,34,220,13,40,62,22,10,20,53
"E00033543",254,51,22,29,203,11,32,39,32,7,28,54
"E00033544",227,31,9,22,196,22,30,54,38,0,17,35
"E00033545",249,48,25,23,201,20,40,34,32,11,28,36
"E00033546",356,43,23,20,313,19,36,30,54,10,64,100
"E00033547",292,38,9,29,254,17,32,66,44,30,11,54
"E00033548",235,44,10,34,191,9,26,64,48,12,14,18
"E00033549",337,51,31,20,286,19,62,32,34,5,60,74
"E00033550",301,35,21,14,266,13,34,70,34,10,33,72
"E00033551",219,43,38,5,176,16,38,21,14,10,31,46
"E00033552",330,26,18,8,304,16,44,64,36,35,35,74
"E00033553",354,69,53,16,285,12,40,60,34,5,49,85
"E00033554",331,15,10,5,316,8,44,33,40,22,55,114
"E00033555",269,62,31,31,207,8,48,35,26,10,14,66
"E00033556",312,23,12,11,289,11,42,77,24,25,40,70
"E00033557",317,26,18,8,291,2,46,90,32,15,27,79
"E00033558",300,22,10,12,278,10,36,70,36,5,34,87
"E00033559",260,32,18,14,228,11,38,24,38,10,20,87
"E00033560",316,19,9,10,297,0,50,48,32,10,52,105
"E00033561",299,23,15,8,276,13,26,45,26,5,41,120
"E00033562",314,18,11,7,296,0,38,52,44,15,21,126
"E00033563",341,21,9,12,320,5,62,29,48,16,52,108
"E00033564",345,41,18,23,304,8,44,38,52,12,55,95
"E00033565",286,20,10,10,266,12,50,38,46,0,52,68
"E00033566",310,72,48,24,238,16,30,51,26,20,47,48
"E00033567",342,24,14,10,318,24,28,104,42,20,36,64
"E00033568",348,47,24,23,301,42,28,59,32,34,26,80
"E00033569",255,32,14,18,223,9,26,51,24,0,34,79
"E00033570",375,64,20,44,311,20,22,116,62,5,34,52
"E00033571",243,47,30,17,196,19,44,31,34,0,13,55
"E00033572",279,34,22,12,245,7,44,24,32,5,49,84
"E00033573",187,48,4,44,139,10,10,29,32,5,25,28
"E00033574",321,26,12,14,295,16,22,70,32,5,54,96
"E00033575",244,42,29,13,202,0,32,26,30,5,17,92
"E00033576",231,38,26,12,193,6,40,41,32,0,13,61
"E00033577",290,35,21,14,255,6,34,50,36,5,39,85
"E00033579",317,29,8,21,288,54,22,41,40,10,76,45
"E00033580",247,85,14,71,162,21,26,30,50,5,9,21
"E00033581",496,86,16,70,410,69,30,98,62,32,45,74
"E00033582",334,70,21,49,264,41,32,39,32,0,17,103
"E00033583",230,41,11,30,189,7,22,41,46,0,20,53
"E00033584",232,36,12,24,196,14,16,22,66,15,24,39
"E00033585",291,44,12,32,247,13,20,48,72,10,17,67
"E00033586",285,62,21,41,223,15,20,27,64,10,8,79
"E00033587",286,67,30,37,219,10,54,32,32,5,8,78
"E00033589",315,36,8,28,279,61,36,51,54,10,15,52
"E00033590",173,31,9,22,142,37,14,25,18,5,19,24
"E00033591",220,26,13,13,194,30,34,37,24,21,23,25
"E00033592",307,19,9,10,288,47,28,79,36,0,44,54
"E00033593",200,44,16,28,156,54,12,30,24,5,15,16
"E00033594",367,38,16,22,329,48,34,66,36,21,50,74
"E00033595",309,80,42,38,229,36,18,35,40,15,37,48
"E00033596",286,62,26,36,224,48,12,47,46,16,17,38
"E00033597",223,40,8,32,183,19,28,45,24,5,22,40
"E00033598",214,69,19,50,145,26,12,46,36,0,7,18
"E00033599",225,63,15,48,162,58,8,34,28,5,12,17
"E00033600",240,77,46,31,163,31,32,30,24,0,22,24
"E00033601",264,62,10,52,202,66,14,28,38,5,4,47
"E00033602",273,46,9,37,227,2,22,38,72,0,12,81
"E00033603",302,53,22,31,249,42,22,17,46,22,59,41
"E00033604",244,66,19,47,178,43,10,24,56,0,0,45
"E00033605",286,43,10,33,243,14,14,34,54,11,34,82
"E00033606",252,40,7,33,212,14,4,41,62,11,4,76
"E00033607",214,57,16,41,157,51,8,38,32,5,0,23
"E00033608",330,52,23,29,278,23,28,33,44,20,60,70
"E00033611",302,28,7,21,274,7,26,24,60,0,42,115
"E00033613",255,60,42,18,195,15,22,34,32,0,14,78
"E00033614",338,34,9,25,304,15,16,41,80,11,39,102
"E00033616",366,28,11,17,338,3,32,66,66,20,40,111
"E00033618",362,47,15,32,315,18,28,48,72,5,41,103
"E00033620",309,27,13,14,282,6,22,60,52,22,31,89
"E00033621",270,27,7,20,243,24,10,51,30,26,34,68
"E00033623",364,67,16,51,297,45,44,36,78,10,23,61
"E00033624",280,45,19,26,235,33,30,23,30,11,33,75
"E00033625",323,28,11,17,295,6,22,85,44,36,33,69
"E00033626",438,47,4,43,391,28,8,171,66,31,58,29
"E00033627",356,38,3,35,318,37,14,130,58,37,23,19
"E00033628",312,47,18,29,265,59,22,48,44,22,31,39
"E00033629",438,43,10,33,395,33,32,90,80,31,58,71
"E00033630",237,67,16,51,170,24,18,19,38,0,34,37
"E00033631",227,83,44,39,144,21,14,25,14,5,42,23
"E00033632",334,48,13,35,286,97,14,60,38,26,18,33
"E00033633",240,26,15,11,214,13,36,40,44,15,33,33
"E00033634",362,61,28,33,301,51,32,62,32,6,58,60
"E00033635",270,61,20,41,209,10,34,27,28,5,43,62
"E00033636",417,43,13,30,374,69,20,93,68,35,30,59
"E00033637",483,56,12,44,427,82,10,100,70,35,61,69
"E00033639",302,34,11,23,268,61,24,48,44,23,23,45
"E00033640",304,42,16,26,262,35,22,61,32,20,29,63
"E00033641",303,32,17,15,271,5,48,48,52,6,47,65
"E00033642",366,38,25,13,328,10,50,36,44,30,51,107
"E00033643",229,38,11,27,191,47,18,53,32,5,4,32
"E00033644",228,26,10,16,202,65,12,21,20,23,15,46
"E00033645",251,36,14,22,215,51,14,23,40,15,39,33
"E00033646",105,14,4,10,91,12,10,24,0,0,25,20
"E00033647",257,24,9,15,233,26,8,50,36,21,29,63
"E00033648",259,55,22,33,204,15,22,17,46,28,10,66
"E00033649",311,21,0,21,290,45,0,111,62,15,41,16
"E00033650",297,53,18,35,244,38,20,45,32,16,35,58
"E00033651",141,15,5,10,126,33,8,31,10,5,13,26
"E00033652",281,49,18,31,232,48,20,35,38,17,32,42
"E00033653",278,24,1,23,254,21,4,104,42,21,36,26
"E00033654",212,16,6,10,196,22,16,26,26,20,40,46
"E00033655",433,62,16,46,371,90,28,91,40,21,63,38
"E00033656",220,22,10,12,198,34,12,42,26,20,35,29
"E00033657",210,22,10,12,188,30,22,34,20,26,25,31
"E00033658",309,33,5,28,276,50,16,89,42,11,22,46
"E00033659",392,43,13,30,349,30,36,65,46,36,51,85
"E00033660",303,35,13,22,268,39,40,53,42,22,24,48
"E00033662",374,45,21,24,329,76,36,39,36,21,31,90
"E00033663",215,77,16,61,138,11,12,9,20,21,18,47
"E00033664",233,88,43,45,145,12,30,27,14,5,24,33
"E00033665",436,36,15,21,400,50,24,122,48,29,51,76
"E00033666",236,73,37,36,163,48,20,39,16,6,14,20
"E00033667",284,57,19,38,227,36,38,28,32,0,20,73
"E00033668",278,36,9,27,242,17,32,49,22,5,16,101
"E00033669",297,36,18,18,261,47,30,31,38,10,38,67
"E00033670",289,93,4,89,196,10,2,20,130,0,22,12
"E00033672",372,51,14,37,321,54,20,43,58,16,66,64
"E00033673",250,52,15,37,198,46,26,29,32,0,25,40
"E00033677",225,57,29,28,168,11,30,20,32,0,17,58
"E00033678",299,123,36,87,176,6,12,16,84,0,13,45
"E00033684",421,94,40,54,327,44,34,45,76,0,40,88
"E00033685",321,40,17,23,281,65,34,32,26,25,48,51
"E00033686",271,51,19,32,220,44,24,50,30,15,27,30
"E00033687",389,56,13,43,333,38,14,61,50,23,57,90
"E00033688",265,46,16,30,219,40,16,25,28,32,21,57
"E00033689",330,54,30,24,276,41,34,44,28,40,37,52
"E00033690",356,65,25,40,291,33,20,31,80,17,10,100
"E00033691",216,48,8,40,168,10,16,38,30,5,17,52
"E00033692",296,117,8,109,179,2,8,13,140,0,4,12
"E00033694",235,51,10,41,184,58,12,26,18,10,33,27
"E00033695",304,50,12,38,254,42,28,60,34,16,27,47
"E00033696",426,71,30,41,355,68,56,47,70,6,42,66
"E00033697",341,44,19,25,297,25,36,55,52,32,48,49
"E00033698",410,40,15,25,370,38,40,85,50,17,43,97
"E00033699",323,39,19,20,284,25,26,74,60,0,36,63
"E00033700",209,34,12,22,175,29,26,39,24,5,13,39
"E00033701",363,27,9,18,336,24,16,77,50,30,49,90
"E00033702",161,68,38,30,93,6,14,20,20,0,15,18
"E00033703",276,106,46,60,170,17,38,36,22,5,8,44
"E00033704",393,15,1,14,378,22,10,130,38,26,93,59
"E00033705",366,20,5,15,346,12,12,109,70,15,35,93
"E00033706",264,47,17,30,217,34,40,34,10,18,28,53
"E00033707",241,47,13,34,194,24,16,37,52,5,13,47
"E00033708",194,67,22,45,127,15,30,7,28,0,6,41
"E00033709",202,22,12,10,180,23,10,34,16,13,46,38
"E00033710",307,49,20,29,258,41,16,58,42,20,9,72
"E00033711",124,37,10,27,87,18,16,18,12,0,4,19
"E00033712",360,17,10,7,343,22,24,46,40,26,70,115
"E00033713",271,45,13,32,226,10,32,77,46,5,21,35
"E00033715",362,51,4,47,311,69,16,74,50,16,20,66
"E00033716",204,80,26,54,124,8,14,14,26,20,21,21
"E00033717",239,35,6,29,204,16,12,107,26,11,21,11
"E00033718",334,27,2,25,307,35,20,99,70,10,36,37
"E00033719",347,25,2,23,322,11,8,130,56,15,62,40
"E00033720",324,35,18,17,289,20,42,42,44,10,28,103
"E00033721",312,20,2,18,292,20,10,96,38,10,70,48
"E00033722",224,23,17,6,201,32,26,31,34,0,23,55
"E00033723",372,24,17,7,348,14,28,101,56,22,39,88
"E00033724",321,46,25,21,275,15,26,45,40,15,61,73
"E00033725",329,53,16,37,276,23,32,58,42,27,31,63
"E00033726",230,37,9,28,193,10,22,22,32,15,30,62
"E00033727",305,48,24,24,257,34,30,48,40,6,39,60
"E00033728",442,13,0,13,429,9,18,96,52,21,95,138
"E00033729",231,33,10,23,198,39,14,43,24,5,22,51
"E00033730",301,31,15,16,270,24,38,68,44,15,37,44
"E00033731",164,43,8,35,121,33,6,28,24,10,4,16
"E00033732",276,37,12,25,239,19,38,56,42,6,28,50
"E00033733",237,28,9,19,209,26,22,41,38,10,19,53
"E00033734",230,42,10,32,188,39,20,44,34,23,13,15
"E00033735",111,80,67,13,31,0,12,0,12,0,0,7
"E00033736",249,57,14,43,192,24,14,47,44,10,15,38
"E00033737",386,40,8,32,346,15,28,76,38,36,52,101
"E00033738",188,45,15,30,143,16,28,15,20,15,10,39
"E00033739",252,29,10,19,223,39,16,41,30,20,21,56
"E00033740",317,48,18,30,269,29,34,56,40,5,30,75
"E00033741",281,54,15,39,227,36,28,45,44,16,22,36
"E00033742",290,40,8,32,250,43,24,53,44,11,22,53
"E00033743",270,32,10,22,238,26,14,52,32,22,40,52
"E00033744",356,46,23,23,310,44,34,65,32,11,47,77
"E00033745",199,67,44,23,132,28,42,20,14,0,15,13
"E00033746",291,36,15,21,255,41,40,31,42,23,18,60
"E00033747",364,45,8,37,319,36,14,73,26,19,58,93
"E00033748",264,38,19,19,226,37,26,49,32,5,27,50
"E00033749",275,39,15,24,236,23,20,32,48,11,36,66
"E00033750",353,40,6,34,313,23,8,116,40,36,17,73
"E00033752",420,62,18,44,358,74,38,73,64,15,41,53
"E00033753",251,25,9,16,226,25,30,54,50,11,23,33
"E00033754",307,35,6,29,272,25,12,87,50,25,23,50
"E00033755",319,23,6,17,296,15,14,79,54,15,39,80
"E00033756",319,31,3,28,288,47,10,119,60,5,22,25
"E00033758",251,34,17,17,217,16,28,44,48,5,14,62
"E00033759",202,50,34,16,152,26,20,18,12,16,33,27
"E00033762",306,35,8,27,271,34,12,39,48,17,53,68
"E00033763",331,26,5,21,305,37,6,99,54,0,77,32
"E00033764",384,14,4,10,370,33,8,116,62,25,46,80
"E00033765",312,43,20,23,269,13,34,57,32,5,65,63
"E00033766",388,18,6,12,370,18,12,74,32,36,114,84
"E00033767",282,29,5,24,253,18,14,81,58,17,29,36
"E00033768",275,35,13,22,240,16,22,46,46,16,23,71
"E00033769",207,89,64,25,118,2,20,36,18,5,11,26
"E00033770",420,9,0,9,411,9,4,100,46,30,100,122
"E00033771",366,18,3,15,348,53,6,104,64,21,51,49
"E00033773",279,27,17,10,252,14,34,53,44,10,36,61
"E00033774",290,44,17,27,246,9,26,63,54,10,21,63
"E00033775",455,53,8,45,402,71,24,80,70,28,82,47
"E00033776",293,72,53,19,221,27,26,26,30,0,38,74
"E00033777",271,18,3,15,253,25,40,78,40,0,18,52
"E00033778",340,32,6,26,308,15,8,131,44,20,51,39
"E00033779",284,55,11,44,229,36,8,40,44,34,27,40
"E00033780",253,22,9,13,231,14,36,55,34,6,20,66
"E00033781",343,85,38,47,258,23,28,39,36,27,35,70
"E00033782",299,40,16,24,259,23,36,61,40,5,44,50
"E00033783",323,32,11,21,291,14,20,66,36,28,59,68
"E00033784",482,57,19,38,425,40,40,123,38,50,58,76
"E00033785",298,33,10,23,265,29,24,44,50,10,34,74
"E00033786",451,17,0,17,434,13,6,69,52,21,120,153
"E00033787",349,21,5,16,328,34,32,65,50,30,29,88
"E00033788",318,18,2,16,300,10,6,80,42,20,95,47
"E00033789",295,15,9,6,280,16,28,64,38,10,47,77
"E00033790",303,21,4,17,282,20,8,103,40,25,34,52
"E00033791",363,41,14,27,322,82,18,62,44,27,50,39
"E00033792",203,15,3,12,188,20,12,40,34,6,31,45
"E00033793",327,44,13,31,283,56,18,52,20,15,70,52
"E00033794",287,32,8,24,255,70,14,58,38,0,37,38
"E00033795",283,37,13,24,246,16,20,76,38,11,37,48
"E00033796",213,27,13,14,186,22,18,13,30,30,17,56
"E00033797",236,35,15,20,201,27,28,23,32,5,42,44
"E00033798",362,31,20,11,331,15,32,47,50,23,71,93
"E00033799",300,32,17,15,268,30,48,38,22,10,57,63
"E00033800",201,23,2,21,178,20,2,74,40,20,13,9
"E00033801",267,45,22,23,222,38,44,24,34,5,10,67
"E00033802",189,24,10,14,165,17,18,24,18,5,36,47
"E00033803",267,41,20,21,226,30,24,27,38,17,20,70
"E00033804",291,42,17,25,249,34,26,24,30,34,42,59
"E00033805",177,56,29,27,121,21,16,7,18,12,11,36
"E00033806",190,84,4,80,106,4,4,22,36,0,11,29
"E00033807",441,110,13,97,331,69,16,41,76,16,40,73
"E00033808",246,36,17,19,210,14,18,25,14,56,51,32
"E00033810",264,87,18,69,177,34,4,60,30,26,17,6
"E00033811",581,81,23,58,500,57,36,67,42,110,132,56
"E00033812",391,79,20,59,312,63,8,75,46,31,65,24
"E00033813",534,98,16,82,436,50,20,66,36,70,125,69
"E00033814",353,64,12,52,289,89,14,86,34,21,8,37
"E00033815",311,85,21,64,226,50,14,49,50,0,35,28
"E00033816",313,41,18,23,272,45,18,65,44,35,25,40
"E00033818",321,66,42,24,255,60,12,66,24,36,41,16
"E00033819",235,90,8,82,145,18,4,44,40,15,11,13
"E00033820",251,79,11,68,172,24,18,59,26,10,8,27
"E00033821",161,81,23,58,80,9,8,3,36,0,12,12
"E00033822",429,42,12,30,387,98,22,54,40,41,80,52
"E00033823",167,20,8,12,147,3,10,14,20,10,61,29
"E00033824",483,44,6,38,439,92,8,97,26,50,126,40
"E00033825",305,40,9,31,265,59,30,68,36,27,14,31
"E00033826",275,94,4,90,181,8,4,15,118,0,0,36
"E00033827",224,114,6,108,110,6,2,13,40,6,20,23
"E00033828",345,59,18,41,286,54,18,62,46,28,31,47
"E00033829",207,96,2,94,111,16,0,12,56,0,11,16
"E00033832",209,93,11,82,116,5,4,3,78,0,10,16
"E00033833",298,132,8,124,166,23,0,38,56,21,5,23
"E00033836",118,72,13,59,46,0,0,16,24,0,0,6
"E00033837",287,53,13,40,234,8,22,21,20,18,64,81
"E00033838",259,28,9,19,231,45,18,48,30,27,10,53
"E00033839",519,93,50,43,426,28,88,68,50,17,55,120
"E00033840",334,151,5,146,183,36,0,37,42,10,12,46
"E00033841",286,78,25,53,208,20,22,17,28,22,45,54
"E00033842",368,108,13,95,260,53,0,80,50,31,19,27
"E00033843",371,43,15,28,328,59,22,64,40,77,31,35
"E00033844",348,50,18,32,298,46,36,30,22,52,75,37
"E00033845",213,98,33,65,115,4,8,22,44,0,4,33
"E00033846",411,108,35,73,303,28,6,20,86,31,68,64
"E00033847",246,65,17,48,181,33,10,27,40,10,30,31
"E00033848",383,29,12,17,354,14,40,77,64,30,49,80
"E00033849",347,20,11,9,327,18,48,75,52,21,37,76
"E00033850",378,41,23,18,337,8,60,67,58,11,42,91
"E00033851",291,39,19,20,252,17,28,32,32,16,24,103
"E00033852",260,33,18,15,227,7,24,44,26,29,9,88
"E00033853",276,35,8,27,241,24,32,41,66,22,10,46
"E00033854",373,27,15,12,346,13,50,47,42,33,62,99
"E00033855",175,74,40,34,101,5,10,23,24,5,0,34
"E00033856",246,134,63,71,112,15,34,21,22,0,14,6
"E00033857",248,42,21,21,206,3,38,45,44,10,17,49
"E00033859",246,45,8,37,201,4,38,41,40,26,13,39
"E00033861",296,94,38,56,202,5,20,44,68,15,10,40
"E00033862",294,51,25,26,243,12,40,58,52,6,24,51
"E00033863",310,26,10,16,284,2,44,90,46,17,33,52
"E00033864",279,29,19,10,250,4,30,59,30,26,18,83
"E00033865",368,28,13,15,340,16,38,93,36,15,49,93
"E00033866",310,31,22,9,279,6,40,43,40,15,50,85
"E00033867",299,30,16,14,269,10,44,55,28,6,34,92
"E00033868",333,23,16,7,310,4,18,95,36,10,53,94
"E00033869",315,24,20,4,291,10,46,41,38,6,34,116
"E00033870",257,120,23,97,137,37,8,32,28,0,10,22
"E00033871",298,24,12,12,274,17,40,68,34,20,30,65
"E00033872",330,31,15,16,299,6,32,72,40,36,43,70
"E00033873",316,56,25,31,260,7,32,43,34,10,50,84
"E00033874",329,32,23,9,297,7,42,53,34,5,36,120
"E00033875",318,21,12,9,297,9,48,86,24,15,39,76
"E00033876",289,32,18,14,257,0,44,71,26,11,46,59
"E00033877",351,25,15,10,326,7,40,77,40,10,49,103
"E00033878",287,35,22,13,252,8,48,53,50,5,29,59
"E00033879",300,23,12,11,277,8,22,60,52,16,39,80
"E00033880",457,46,21,25,411,27,60,66,70,11,71,106
"E00033881",317,30,15,15,287,6,36,72,40,15,40,78
"E00033882",280,21,13,8,259,7,40,59,24,26,37,66
"E00033883",287,44,21,23,243,10,36,65,42,5,36,49
"E00033884",333,33,24,9,300,9,44,50,40,26,51,80
"E00033885",466,74,17,57,392,24,44,84,92,22,32,94
"E00033886",276,25,19,6,251,7,44,56,40,5,20,79
"E00033887",388,29,19,10,359,13,34,52,40,15,68,137
"E00033888",335,33,19,14,302,4,40,44,34,21,34,125
"E00033889",306,23,16,7,283,2,46,55,56,37,8,79
"E00033890",198,75,8,67,123,30,10,11,26,16,0,30
"E00033891",252,56,20,36,196,10,36,41,38,0,12,59
"E00033892",114,32,8,24,82,10,14,4,20,5,5,24
"E00033893",265,39,18,21,226,10,44,51,36,15,32,38
"E00033894",311,32,17,15,279,13,38,67,32,5,25,99
"E00033895",207,51,5,46,156,15,16,47,38,0,5,35
"E00033896",291,43,15,28,248,5,20,63,50,16,17,77
"E00033897",274,37,16,21,237,11,46,40,40,10,8,82
"E00033898",359,50,10,40,309,34,34,57,40,22,49,73
"E00033899",259,61,15,46,198,45,18,29,28,15,9,54
"E00033900",265,31,6,25,234,38,14,57,34,0,24,67
"E00033901",283,125,17,108,158,10,12,13,54,5,24,40
"E00033902",328,25,8,17,303,48,26,53,32,39,27,78
"E00033903",210,61,8,53,149,22,6,31,30,11,12,37
"E00033904",296,62,31,31,234,13,68,21,12,6,32,82
"E00033905",181,78,29,49,103,7,34,11,16,0,14,21
"E00033906",202,95,14,81,107,12,4,12,18,5,20,36
"E00033907",286,100,9,91,186,25,10,22,34,10,32,53
"E00033908",282,106,6,100,176,37,12,21,58,0,14,34
"E00033909",280,30,8,22,250,34,26,29,30,21,14,96
"E00033910",386,56,12,44,330,54,16,66,32,34,53,75
"E00033911",368,44,13,31,324,52,18,75,50,15,66,48
"E00033913",233,43,4,39,190,13,2,82,64,0,5,24
"E00033914",330,57,14,43,273,40,16,71,26,10,41,69
"E00033915",196,49,10,39,147,33,10,32,24,0,13,35
"E00033917",289,55,17,38,234,19,14,65,50,0,21,65
"E00033918",247,107,45,62,140,22,32,21,20,0,17,28
"E00033919",250,70,16,54,180,15,26,29,12,5,41,52
"E00033920",245,91,44,47,154,9,30,22,36,6,8,43
"E00033921",313,83,12,71,230,36,10,55,46,21,27,35
"E00033922",341,38,10,28,303,24,24,52,50,5,59,89
"E00033923",232,76,12,64,156,37,22,31,24,6,9,27
"E00033924",381,75,10,65,306,65,14,52,42,30,23,80
"E00033925",233,126,8,118,107,37,6,19,14,0,13,18
"E00033926",300,49,11,38,251,38,24,62,42,10,43,32
"E00033927",378,35,9,26,343,63,30,45,48,27,43,87
"E00033928",262,38,17,21,224,33,18,43,38,11,29,52
"E00033930",260,57,11,46,203,36,18,19,36,5,25,64
"E00033931",278,70,9,61,208,27,10,49,32,20,36,34
"E00033932",316,30,15,15,286,25,28,43,26,16,42,106
"E00033933",256,23,10,13,233,28,14,36,32,34,23,66
"E00033934",288,100,8,92,188,33,12,26,34,12,33,38
"E00033935",330,110,14,96,220,34,10,42,64,5,30,35
"E00033936",273,51,9,42,222,50,20,19,40,16,21,56
"E00033937",196,34,8,26,162,37,8,37,42,5,5,28
"E00033938",282,49,8,41,233,30,26,72,54,11,5,35
"E00033939",273,46,5,41,227,14,20,24,26,25,64,54
"E00033940",301,67,11,56,234,39,12,20,46,10,49,58
"E00033941",318,58,18,40,260,25,18,31,44,21,38,83
"E00033942",354,90,41,49,264,16,42,40,46,28,32,60
"E00033943",292,60,10,50,232,34,28,60,44,5,18,43
"E00033944",248,76,4,72,172,16,12,13,34,6,20,71
"E00033945",183,49,14,35,134,16,12,23,28,0,10,45
"E00033946",410,60,18,42,350,36,20,81,50,41,57,65
"E00033947",269,34,7,27,235,44,12,36,24,17,37,65
"E00033948",333,42,18,24,291,49,30,51,70,22,20,49
"E00033949",280,77,22,55,203,59,16,44,40,6,14,24
"E00033950",413,58,24,34,355,64,30,75,62,20,34,70
"E00033951",249,49,20,29,200,20,24,15,44,0,32,65
"E00033952",354,40,10,30,314,22,30,25,66,16,19,136
"E00033953",379,73,12,61,306,40,22,53,58,31,33,69
"E00033954",214,54,22,32,160,29,20,9,28,10,23,41
"E00033955",344,61,22,39,283,55,26,59,42,11,19,71
"E00033956",102,12,7,5,90,21,16,7,6,5,4,31
"E00033957",314,55,13,42,259,47,14,39,24,33,32,70
"E00033958",320,37,12,25,283,50,18,55,48,20,13,79
"E00033959",264,60,15,45,204,48,34,24,38,15,9,36
"E00033960",331,35,11,24,296,32,26,82,28,11,42,75
"E00033961",277,58,15,43,219,31,26,33,32,10,31,56
"E00033962",292,37,13,24,255,15,20,43,46,15,48,68
"E00033963",357,64,18,46,293,71,26,67,54,5,16,54
"E00033964",286,103,12,91,183,47,18,25,32,6,21,34
"E00033965",253,74,12,62,179,22,24,19,24,20,33,37
"E00033966",257,61,10,51,196,42,20,31,38,6,20,39
"E00033967",278,43,16,27,235,61,34,32,58,10,17,23
"E00033968",145,71,8,63,74,2,8,10,6,12,23,13
"E00033969",246,46,12,34,200,16,14,33,36,0,38,63
"E00033970",285,76,18,58,209,14,40,53,26,16,30,30
"E00033971",183,24,10,14,159,8,18,36,26,5,29,37
"E00033972",251,78,16,62,173,16,26,58,14,5,24,30
"E00033973",182,28,10,18,154,22,26,26,20,5,13,42
"E00033974",261,66,18,48,195,31,16,27,50,15,16,40
"E00033975",348,79,16,63,269,59,22,51,44,5,13,75
"E00033976",211,64,18,46,147,13,8,24,36,10,18,38
"E00033977",156,40,18,22,116,11,12,10,18,8,26,31
"E00033978",165,89,22,67,76,0,20,7,12,10,5,22
"E00033979",121,44,25,19,77,21,8,9,8,0,0,31
"E00033980",242,41,18,23,201,39,28,24,40,0,19,51
"E00033981",148,52,35,17,96,20,20,7,24,0,0,25
"E00033982",110,13,8,5,97,16,10,36,6,0,0,29
"E00033983",233,44,8,36,189,39,10,32,34,10,22,42
"E00033984",235,33,8,25,202,17,32,29,26,11,27,60
"E00033985",206,55,12,43,151,37,12,24,28,11,8,31
"E00033986",266,31,15,16,235,21,22,59,36,12,21,64
"E00033987",260,69,14,55,191,30,12,44,30,5,18,52
"E00033988",246,46,7,39,200,30,14,27,48,11,21,49
"E00033989",229,52,8,44,177,31,10,23,40,10,24,39
"E00033990",314,34,8,26,280,43,4,57,36,26,44,70
"E00033991",289,30,12,18,259,31,28,57,36,23,10,74
"E00033992",264,53,19,34,211,12,42,45,28,5,22,57
"E00033993",418,98,29,69,320,44,24,80,58,25,42,47
"E00033994",376,24,10,14,352,78,14,68,30,16,70,76
"E00033995",252,28,11,17,224,30,26,34,40,11,16,67
"E00033996",297,19,8,11,278,41,22,47,60,22,14,72
"E00033997",341,48,16,32,293,38,22,56,48,15,58,56
"E00033998",293,33,18,15,260,36,42,48,38,15,36,45
"E00033999",290,34,11,23,256,57,16,30,24,5,59,65
"E00034000",295,33,15,18,262,35,28,33,24,21,48,73
"E00034001",301,60,21,39,241,21,32,56,56,15,27,34
"E00034002",239,35,20,15,204,17,50,32,22,27,19,37
"E00034003",229,29,10,19,200,22,12,59,20,13,39,35
"E00034004",204,33,14,19,171,31,30,19,24,0,15,52
"E00034005",309,41,25,16,268,20,48,55,32,22,34,57
"E00034006",265,45,25,20,220,7,32,57,28,0,28,68
"E00034007",214,37,18,19,177,18,24,22,32,5,34,42
"E00034008",280,37,14,23,243,29,30,20,44,0,36,84
"E00034009",242,46,31,15,196,15,32,17,26,32,24,50
"E00034010",205,56,38,18,149,8,28,14,24,5,32,38
"E00034011",363,34,6,28,329,26,14,102,64,22,37,64
"E00034012",281,20,8,12,261,41,20,29,52,11,31,77
"E00034013",270,57,12,45,213,26,20,29,32,9,23,74
"E00034014",239,42,29,13,197,9,46,23,18,5,31,65
"E00034015",267,32,18,14,235,25,28,51,30,15,40,46
"E00034016",265,30,12,18,235,40,38,34,38,0,37,48
"E00034017",326,23,9,14,303,33,28,37,42,10,63,90
"E00034019",287,54,13,41,233,25,20,59,34,16,33,46
"E00034020",323,28,8,20,295,53,22,62,44,10,46,58
"E00034021",304,32,17,15,272,20,22,67,38,15,49,61
"E00034022",355,53,20,33,302,23,22,94,48,36,21,58
"E00034023",229,79,28,51,150,42,18,28,26,0,11,25
"E00034024",299,67,12,55,232,48,4,49,42,15,41,33
"E00034025",360,84,27,57,276,41,24,42,50,16,55,48
"E00034026",271,46,6,40,225,51,20,36,42,6,27,43
"E00034027",230,40,7,33,190,47,12,36,38,15,14,28
"E00034028",305,87,22,65,218,49,18,47,46,7,37,14
"E00034029",380,73,21,52,307,37,18,62,60,40,35,55
"E00034030",268,39,15,24,229,42,16,59,46,6,22,38
"E00034031",236,45,10,35,191,13,16,35,24,11,33,59
"E00034032",324,32,20,12,292,12,22,46,36,5,84,87
"E00034033",255,19,9,10,236,26,24,50,34,11,31,60
"E00034034",307,50,15,35,257,21,22,30,34,15,71,64
"E00034035",314,35,11,24,279,40,30,30,42,21,41,75
"E00034036",314,22,13,9,292,19,28,43,38,16,38,110
"E00034037",333,37,14,23,296,17,36,84,22,10,46,81
"E00034038",346,41,11,30,305,28,26,44,46,19,46,96
"E00034039",301,54,22,32,247,14,28,43,58,11,23,70
"E00034040",268,24,7,17,244,22,26,46,40,20,22,68
"E00034041",316,39,24,15,277,13,34,47,36,25,44,78
"E00034042",307,44,20,24,263,40,28,51,36,15,29,64
"E00034043",336,89,32,57,247,14,10,51,30,29,53,60
"E00034044",350,33,15,18,317,34,24,52,38,10,90,69
"E00034045",330,57,20,37,273,44,30,57,44,25,31,42
"E00034046",276,52,15,37,224,22,28,47,36,11,33,47
"E00034047",283,48,19,29,235,23,22,68,42,20,24,36
"E00034048",266,39,23,16,227,6,32,49,40,20,20,60
"E00034049",297,44,20,24,253,29,20,53,60,36,13,42
"E00034050",321,40,8,32,281,36,22,80,50,16,24,53
"E00034051",199,44,20,24,155,26,8,38,52,5,0,26
"E00034052",266,37,11,26,229,32,14,71,46,10,20,36
"E00034053",362,65,6,59,297,32,18,70,36,23,65,53
"E00034054",328,37,17,20,291,33,20,82,42,5,34,75
"E00034055",327,88,10,78,239,24,6,39,34,10,55,71
"E00034056",237,71,18,53,166,45,20,33,40,5,9,14
"E00034057",237,42,11,31,195,47,14,66,24,5,9,30
"E00034058",277,81,16,65,196,36,14,28,50,10,22,36
"E00034059",430,60,18,42,370,71,38,74,54,15,54,64
"E00034061",354,40,9,31,314,35,20,84,44,0,43,88
"E00034062",474,75,13,62,399,27,18,33,36,27,33,225
"E00034063",468,35,11,24,433,4,2,27,44,27,12,317
"E00034064",483,17,3,14,466,0,12,23,24,0,11,396
"E00034065",292,49,18,31,243,2,34,47,24,16,45,75
"E00034066",270,67,22,45,203,29,32,29,50,0,19,44
"E00034067",307,41,13,28,266,31,16,39,52,21,35,72
"E00034068",299,70,13,57,229,34,16,22,40,27,12,78
"E00034069",435,62,11,51,373,38,12,31,38,28,21,205
"E00034070",359,58,8,50,301,55,8,43,52,35,31,77
"E00034071",385,78,18,60,307,46,10,65,62,10,25,89
"E00034072",300,78,30,48,222,36,12,41,38,0,30,65
"E00034073",277,32,5,27,245,30,10,17,30,11,20,127
"E00034074",332,67,13,54,265,61,12,57,76,5,13,41
"E00034075",261,82,18,64,179,46,18,27,38,20,14,16
"E00034076",301,63,16,47,238,32,2,39,52,32,0,81
"E00034077",247,75,23,52,172,55,12,28,52,0,6,19
"E00034078",266,69,17,52,197,34,14,40,44,0,30,35
"E00034079",291,80,13,67,211,40,8,43,70,5,4,41
"E00034080",236,35,5,30,201,23,22,24,58,0,13,61
"E00034081",378,101,33,68,277,37,12,14,92,26,21,75
"E00034082",241,47,16,31,194,31,24,36,52,16,5,30
"E00034083",273,29,6,23,244,30,10,41,42,5,28,88
"E00034084",282,37,10,27,245,30,6,34,16,21,43,95
"E00034085",268,58,11,47,210,52,10,33,74,5,9,27
"E00034086",178,21,7,14,157,19,4,15,10,40,31,38
"E00034087",251,20,9,11,231,23,6,3,24,5,16,154
"E00034088",301,73,13,60,228,51,8,48,64,6,12,39
"E00034089",308,10,6,4,298,17,10,17,42,15,31,166
"E00034090",330,34,17,17,296,14,6,21,28,22,37,168
"E00034091",241,12,7,5,229,9,6,25,18,12,30,129
"E00034092",226,22,7,15,204,14,6,18,18,0,16,132
"E00034093",385,66,8,58,319,7,14,31,36,10,38,183
"E00034094",417,29,11,18,388,22,20,24,44,11,23,244
"E00034095",250,58,18,40,192,19,16,33,68,0,8,48
"E00034096",336,36,13,23,300,7,14,15,40,0,26,198
"E00034097",342,18,7,11,324,4,22,14,30,11,42,201
"E00034098",334,36,15,21,298,10,14,12,40,10,27,185
"E00034099",316,32,5,27,284,0,16,21,20,5,11,211
"E00034100",327,56,13,43,271,23,10,66,68,21,8,75
"E00034101",278,71,20,51,207,32,20,29,58,10,12,46
"E00034102",263,58,13,45,205,51,22,40,38,0,18,36
"E00034104",322,57,14,43,265,38,24,43,58,5,26,71
"E00034105",363,65,13,52,298,22,12,34,44,39,26,121
"E00034106",222,23,7,16,199,12,16,29,36,21,22,63
"E00034107",322,30,15,15,292,33,16,31,54,15,14,129
"E00034108",195,77,39,38,118,37,10,18,20,0,5,28
"E00034109",195,45,13,32,150,33,6,12,48,26,9,16
"E00034110",309,46,9,37,263,19,20,51,68,5,31,69
"E00034111",267,47,15,32,220,41,20,47,28,6,29,49
"E00034113",305,28,12,16,277,30,18,51,32,6,66,74
"E00034114",316,30,12,18,286,25,38,44,24,15,53,87
"E00034115",293,33,15,18,260,20,22,62,24,16,52,64
"E00034116",337,42,12,30,295,86,28,35,40,25,12,69
"E00034117",272,39,16,23,233,64,18,17,38,0,18,78
"E00034118",222,28,11,17,194,36,6,39,34,5,42,32
"E00034119",293,34,20,14,259,36,28,34,44,11,33,73
"E00034120",279,22,16,6,257,39,16,35,32,21,39,75
"E00034121",287,25,8,17,262,40,28,61,42,10,15,66
"E00034122",327,30,14,16,297,56,40,34,28,29,32,78
"E00034123",362,39,9,30,323,80,14,52,34,34,64,45
"E00034124",337,31,13,18,306,69,34,25,24,32,63,59
"E00034125",294,38,11,27,256,56,24,52,30,10,28,56
"E00034126",371,35,10,25,336,24,38,55,48,30,46,95
"E00034127",350,27,8,19,323,26,28,45,40,43,68,73
"E00034130",288,31,13,18,257,39,22,43,28,10,27,88
"E00034131",379,37,10,27,342,42,38,55,50,13,34,110
"E00034132",189,42,11,31,147,19,20,30,12,0,35,31
"E00034133",248,34,16,18,214,35,8,32,18,22,25,74
"E00034134",311,46,18,28,265,37,24,31,46,22,47,58
"E00034135",221,60,16,44,161,20,12,46,24,0,21,38
"E00034136",335,41,18,23,294,32,22,52,34,11,71,72
"E00034137",269,32,13,19,237,65,18,42,28,17,27,40
"E00034138",306,35,13,22,271,75,16,34,42,20,35,49
"E00034139",299,23,12,11,276,31,44,48,28,0,32,93
"E00034140",234,29,15,14,205,13,26,24,22,6,38,76
"E00034141",228,39,25,14,189,59,34,38,22,5,5,26
"E00034142",388,30,19,11,358,54,30,58,50,22,59,85
"E00034143",309,26,13,13,283,13,40,44,40,15,51,80
"E00034144",361,37,19,18,324,39,26,45,24,22,74,94
"E00034145",250,37,13,24,213,31,30,41,20,33,13,45
"E00034146",310,26,14,12,284,72,28,37,32,38,35,42
"E00034147",247,38,22,16,209,24,20,35,28,24,23,55
"E00034148",409,31,21,10,378,102,12,65,32,59,53,55
"E00034149",280,44,20,24,236,45,18,34,18,16,53,52
"E00034150",208,35,19,16,173,26,14,30,22,11,24,46
"E00034151",305,26,17,9,279,53,30,57,26,21,40,52
"E00034152",298,43,21,22,255,25,22,36,42,11,61,58
"E00034153",312,44,16,28,268,72,26,50,28,26,18,48
"E00034154",341,45,20,25,296,37,32,45,42,17,31,92
"E00034155",398,48,18,30,350,59,18,63,28,46,79,57
"E00034156",240,40,21,19,200,42,6,58,20,27,31,16
"E00034157",293,47,18,29,246,39,28,56,38,5,33,47
"E00034158",335,46,25,21,289,34,28,45,44,0,51,87
"E00034159",289,40,11,29,249,7,26,80,30,21,19,66
"E00034160",267,26,16,10,241,9,38,39,44,29,17,65
"E00034161",264,54,8,46,210,43,26,21,38,10,25,47
"E00034162",354,49,9,40,305,50,28,44,34,22,57,70
"E00034163",253,48,24,24,205,40,14,38,34,11,19,49
"E00034164",338,66,23,43,272,63,24,40,30,5,53,57
"E00034165",263,17,4,13,246,59,16,34,16,57,25,39
"E00034167",394,77,25,52,317,55,34,56,68,25,12,67
"E00034168",331,25,9,16,306,24,36,48,44,21,54,79
"E00034169",277,94,8,86,183,10,10,29,26,16,9,83
"E00034170",304,37,14,23,267,12,24,44,40,10,60,77
"E00034171",244,50,22,28,194,11,22,32,24,10,23,72
"E00034172",290,42,12,30,248,37,26,61,38,5,26,55
"E00034173",243,57,13,44,186,32,12,39,42,25,11,25
"E00034174",251,38,14,24,213,23,20,48,40,21,26,35
"E00034175",248,46,19,27,202,26,20,34,32,13,29,48
"E00034176",162,39,7,32,123,19,8,28,22,11,17,18
"E00034177",267,59,25,34,208,30,26,30,40,5,24,53
"E00034178",295,74,14,60,221,30,24,57,52,0,8,50
"E00034180",360,42,8,34,318,57,28,87,46,5,15,80
"E00034182",133,40,18,22,93,16,6,11,20,6,13,21
"E00034184",252,47,14,33,205,38,8,80,36,0,21,22
"E00034185",238,48,27,21,190,28,24,22,38,15,17,46
"E00034187",221,96,17,79,125,5,16,24,20,16,22,22
"E00034188",335,47,21,26,288,59,18,42,36,10,55,68
"E00034189",276,40,16,24,236,34,16,41,32,10,26,77
"E00034190",257,30,19,11,227,48,16,52,34,10,44,23
"E00034191",239,41,17,24,198,19,22,34,36,15,32,40
"E00034192",352,41,16,25,311,55,32,60,54,17,23,70
"E00034193",283,45,17,28,238,25,30,63,22,11,30,57
"E00034194",246,26,11,15,220,29,22,60,44,0,16,49
"E00034195",236,42,8,34,194,23,20,38,26,11,45,31
"E00034196",337,43,16,27,294,38,34,71,38,20,37,56
"E00034197",317,42,14,28,275,31,36,42,40,5,53,68
"E00034199",322,53,22,31,269,49,16,44,12,5,76,67
"E00034200",328,51,21,30,277,33,16,13,24,5,26,160
"E00034201",262,102,17,85,160,13,10,15,48,6,23,45
"E00034202",287,34,24,10,253,32,46,41,34,10,35,55
"E00034203",395,66,18,48,329,31,16,28,56,12,15,171
"E00034208",249,109,42,67,140,11,22,22,22,22,21,20
"E00034209",168,86,17,69,82,7,8,10,16,0,0,41
"E00034211",243,63,15,48,180,10,8,18,48,0,33,63
"E00034212",253,81,9,72,172,27,4,20,40,6,14,61
"E00034213",439,89,48,41,350,12,52,60,42,10,72,102
"E00034215",135,18,3,15,117,7,6,11,12,6,32,43
"E00034216",451,61,21,40,390,66,32,97,106,21,30,38
"E00034219",279,70,16,54,209,41,20,44,40,14,10,40
"E00034221",276,45,21,24,231,27,52,22,20,11,38,61
"E00034222",350,122,16,106,228,7,22,32,54,0,13,100
"E00034223",237,58,22,36,179,12,26,13,44,5,9,70
"E00034224",383,35,13,22,348,20,16,28,34,22,29,199
"E00034225",323,44,8,36,279,25,38,23,32,11,17,133
"E00034227",360,29,12,17,331,18,12,27,38,11,14,211
"E00034228",400,46,16,30,354,9,20,26,22,0,28,249
"E00034230",423,27,11,16,396,26,14,21,60,10,24,241
"E00034231",358,71,18,53,287,13,16,28,22,5,17,186
"E00034234",359,38,10,28,321,83,24,44,42,11,53,64
"E00034235",339,25,10,15,314,67,16,78,38,7,44,64
"E00034236",286,64,15,49,222,28,24,17,42,11,35,65
"E00034237",310,45,17,28,265,42,18,43,40,20,28,74
"E00034238",140,9,4,5,131,15,12,24,26,10,19,25
"E00034239",349,39,7,32,310,78,26,66,40,10,23,67
"E00034240",286,46,7,39,240,46,38,40,36,11,26,43
"E00034241",293,40,9,31,253,39,16,50,44,6,42,56
"E00034242",277,39,18,21,238,32,34,59,16,28,25,44
"E00034243",431,36,8,28,395,125,30,65,50,21,31,73
"E00034244",321,27,11,16,294,43,20,68,30,21,59,53
"E00034245",297,42,16,26,255,55,24,38,38,21,23,56
"E00034246",284,38,16,22,246,66,18,41,30,11,29,51
"E00034247",255,51,25,26,204,39,28,23,36,20,32,26
"E00034248",205,65,31,34,140,19,24,26,20,5,15,31
"E00034249",289,85,34,51,204,52,4,37,20,27,36,28
"E00034250",388,51,13,38,337,101,20,59,40,16,27,74
"E00034251",277,64,24,40,213,27,18,24,64,5,22,53
"E00034252",447,53,18,35,394,68,22,103,56,10,73,62
"E00034253",394,57,12,45,337,84,14,64,56,7,66,46
"E00034254",323,50,20,30,273,77,18,46,42,28,18,44
"E00034255",337,36,14,22,301,72,36,57,36,21,32,47
"E00034256",336,38,16,22,298,62,30,62,30,15,53,46
"E00034257",298,70,18,52,228,34,26,34,34,5,26,69
"E00034258",340,35,11,24,305,59,26,41,42,39,42,56
"E00034259",316,45,8,37,271,53,14,78,32,22,37,35
"E00034260",266,45,22,23,221,62,18,35,28,22,31,25
"E00034261",291,22,10,12,269,34,20,53,34,29,37,62
"E00034262",295,41,13,28,254,11,14,57,30,26,34,82
"E00034263",230,69,23,46,161,25,4,21,30,0,46,35
"E00034264",315,47,11,36,268,55,20,38,38,7,41,69
"E00034265",549,68,23,45,481,47,50,71,104,27,58,124
"E00034266",311,56,19,37,255,36,28,46,40,16,35,54
"E00034267",269,22,11,11,247,6,26,30,26,5,69,85
"E00034268",462,85,19,66,377,58,24,67,54,23,73,78
"E00034269",204,60,8,52,144,16,24,35,20,20,11,18
"E00034270",341,68,9,59,273,15,16,30,32,20,39,121
"E00034271",301,25,11,14,276,38,26,23,46,21,44,78
"E00034272",311,101,19,82,210,32,8,42,24,7,13,84
"E00034273",158,65,13,52,93,12,4,11,20,5,7,34
"E00034274",212,81,3,78,131,4,2,23,30,17,4,51
"E00034275",295,25,8,17,270,11,54,29,26,10,38,102
"E00034276",310,35,8,27,275,27,32,33,38,10,54,81
"E00034277",247,27,13,14,220,24,28,34,32,5,18,79
"E00034278",330,38,9,29,292,16,12,41,48,30,40,105
"E00034279",298,133,11,122,165,2,0,28,62,0,23,50
"E00034280",140,107,25,82,33,4,2,0,18,0,0,9
"E00034281",170,83,4,79,87,0,0,12,20,0,5,50
"E00034282",410,68,11,57,342,62,18,61,50,15,19,117
"E00034283",370,53,16,37,317,33,20,69,46,10,61,78
"E00034284",272,59,14,45,213,9,24,26,22,20,47,65
"E00034285",313,59,23,36,254,22,36,39,24,20,43,70
"E00034286",325,27,13,14,298,38,32,50,26,10,65,77
"E00034287",279,37,12,25,242,49,24,34,26,28,39,42
"E00034288",304,36,15,21,268,30,16,40,52,10,54,66
"E00034289",226,35,9,26,191,50,18,29,46,5,8,35
"E00034290",297,29,10,19,268,48,14,60,30,20,27,69
"E00034291",221,39,11,28,182,39,12,40,22,11,25,33
"E00034292",268,30,5,25,238,45,20,35,44,12,35,47
"E00034293",267,54,24,30,213,41,22,37,60,10,26,17
"E00034294",567,74,8,66,493,72,30,145,62,49,34,101
"E00034295",228,41,7,34,187,36,6,40,26,21,14,44
"E00034296",321,41,9,32,280,55,44,62,36,10,28,45
"E00034297",285,60,20,40,225,31,20,41,26,16,22,69
"E00034298",323,51,14,37,272,31,40,63,44,10,12,72
"E00034299",253,51,13,38,202,51,18,37,14,5,20,57
"E00034300",244,43,25,18,201,21,26,35,16,10,48,45
"E00034301",266,72,8,64,194,29,16,27,34,25,28,35
"E00034302",289,34,10,24,255,37,10,38,56,10,51,53
"E00034303",259,69,24,45,190,24,20,24,48,11,21,42
"E00034304",259,77,11,66,182,20,16,27,30,14,41,34
"E00034305",271,57,21,36,214,23,40,25,22,0,31,73
"E00034306",315,58,10,48,257,32,26,46,36,27,62,28
"E00034307",241,68,6,62,173,20,8,28,28,0,37,52
"E00034308",353,46,12,34,307,31,24,79,44,10,47,72
"E00034309",270,48,14,34,222,42,12,31,34,14,27,62
"E00034310",337,64,7,57,273,46,8,38,40,17,50,74
"E00034311",298,53,12,41,245,33,14,46,38,7,17,90
"E00034312",302,55,12,43,247,48,16,54,56,0,21,52
"E00034313",332,52,12,40,280,34,12,79,32,37,23,63
"E00034314",259,47,12,35,212,46,10,47,32,5,25,47
"E00034315",228,125,87,38,103,11,38,6,18,0,5,25
"E00034316",256,37,15,22,219,13,24,47,30,18,21,66
"E00034317",391,81,18,63,310,73,36,50,30,37,41,43
"E00034318",285,20,12,8,265,51,36,29,28,10,53,58
"E00034319",310,82,34,48,228,37,38,43,34,18,34,24
"E00034320",180,51,19,32,129,17,14,26,14,5,25,28
"E00034321",109,14,8,6,95,22,8,19,18,0,22,6
"E00034322",288,48,27,21,240,23,22,35,40,0,66,54
"E00034323",298,59,20,39,239,36,24,39,32,11,34,63
"E00034324",296,40,20,20,256,35,36,38,38,15,45,49
"E00034325",265,53,19,34,212,33,30,38,30,20,18,43
"E00034326",256,40,24,16,216,0,48,30,40,0,31,67
"E00034327",272,27,11,16,245,23,16,41,38,10,31,86
"E00034328",336,31,16,15,305,7,18,88,42,5,78,67
"E00034329",244,41,13,28,203,3,32,20,32,16,27,73
"E00034330",231,34,20,14,197,11,44,44,22,12,14,50
"E00034331",271,34,22,12,237,28,36,24,36,16,39,58
"E00034332",324,48,11,37,276,45,32,68,40,15,12,64
"E00034333",300,53,27,26,247,27,28,31,44,15,19,83
"E00034334",207,96,63,33,111,25,22,14,26,0,9,15
"E00034335",254,26,13,13,228,41,20,39,20,11,64,33
"E00034336",228,35,17,18,193,16,32,27,38,10,19,51
"E00034337",350,27,10,17,323,13,32,88,64,11,14,101
"E00034338",272,20,8,12,252,20,30,81,36,0,24,61
"E00034339",302,26,14,12,276,8,40,56,46,15,50,61
"E00034340",230,20,9,11,210,9,28,51,36,5,26,55
"E00034341",342,37,22,15,305,12,42,65,36,32,26,92
"E00034342",224,21,7,14,203,10,32,67,36,5,10,43
"E00034343",258,23,14,9,235,16,20,63,52,5,27,52
"E00034344",277,20,7,13,257,10,22,56,30,5,43,91
"E00034345",232,13,3,10,219,8,16,62,34,5,48,46
"E00034346",111,52,35,17,59,6,12,0,18,0,6,17
"E00034347",230,61,25,36,169,11,22,40,38,5,13,40
"E00034348",246,33,20,13,213,20,44,19,36,12,34,48
"E00034349",267,32,17,15,235,66,18,19,48,5,25,54
"E00034350",252,77,51,26,175,46,22,25,24,5,30,23
"E00034351",332,93,15,78,239,47,14,45,54,15,20,44
"E00034352",268,31,13,18,237,36,28,43,38,11,33,48
"E00034353",277,47,24,23,230,35,22,37,26,0,57,53
"E00034354",258,84,15,69,174,44,14,14,36,5,8,53
"E00034355",322,93,27,66,229,45,26,19,30,15,34,60
"E00034356",136,43,11,32,93,25,14,11,22,0,5,16
"E00034358",362,74,22,52,288,39,18,39,68,20,49,55
"E00034359",253,42,7,35,211,24,12,26,44,5,49,51
"E00034360",166,37,6,31,129,22,16,29,14,12,4,32
"E00034361",198,41,26,15,157,18,30,16,36,0,17,40
"E00034362",194,80,43,37,114,17,22,3,36,6,8,22
"E00034363",263,54,15,39,209,27,30,36,42,0,26,48
"E00034364",216,66,20,46,150,19,18,19,38,0,14,42
"E00034365",308,67,17,50,241,36,20,39,50,0,30,66
"E00034366",345,89,37,52,256,32,24,58,54,18,25,45
"E00034368",271,56,19,37,215,43,14,36,56,0,11,55
"E00034369",255,49,9,40,206,28,16,31,46,0,29,56
"E00034371",246,44,18,26,202,49,30,20,28,5,15,55
"E00034372",274,35,18,17,239,47,28,28,26,6,32,72
"E00034373",204,82,19,63,122,8,20,4,18,7,38,27
"E00034374",265,41,21,20,224,24,28,47,38,10,19,58
"E00034375",424,26,15,11,398,9,46,100,48,5,55,135
"E00034376",341,37,21,16,304,18,30,75,32,10,61,78
"E00034377",322,31,12,19,291,10,14,83,56,11,40,77
"E00034378",324,32,14,18,292,32,16,73,52,15,26,78
"E00034379",348,65,19,46,283,20,22,65,52,20,37,67
"E00034380",335,23,8,15,312,15,34,84,46,16,46,71
"E00034381",570,56,24,32,514,30,44,156,90,47,67,80
"E00034382",358,59,11,48,299,35,32,62,40,25,16,89
"E00034383",467,32,12,20,435,30,20,99,40,38,80,128
"E00034384",330,36,7,29,294,46,24,49,36,21,71,47
"E00034386",399,115,12,103,284,28,14,28,46,23,56,89
"E00034387",240,100,13,87,140,16,18,30,38,16,13,9
"E00034388",262,60,34,26,202,54,24,25,34,5,24,36
"E00034389",208,30,16,14,178,6,36,35,30,0,30,41
"E00034390",363,40,10,30,323,40,28,26,40,21,64,104
"E00034391",387,38,13,25,349,26,20,86,52,10,56,99
"E00034392",336,24,8,16,312,34,28,73,38,43,28,68
"E00034393",260,30,18,12,230,17,36,62,28,10,9,68
"E00034394",290,38,7,31,252,25,24,56,48,0,27,72
"E00034395",242,48,9,39,194,42,16,46,42,10,15,23
"E00034396",307,47,16,31,260,34,18,57,30,21,12,88
"E00034397",322,43,19,24,279,24,16,58,54,20,37,70
"E00034398",289,59,11,48,230,15,26,43,52,10,29,55
"E00034399",336,68,20,48,268,29,36,55,48,15,15,70
"E00034400",272,66,20,46,206,24,14,44,40,21,10,53
"E00034401",370,83,24,59,287,37,8,81,28,5,50,78
"E00034402",285,52,14,38,233,12,26,44,38,5,33,75
"E00034403",306,64,14,50,242,0,28,58,40,5,33,78
"E00034404",297,43,11,32,254,23,16,93,36,11,35,40
"E00034405",349,40,10,30,309,28,28,53,62,20,17,101
"E00034406",350,61,17,44,289,23,14,82,42,6,54,68
"E00034409",388,46,23,23,342,20,40,61,42,10,74,95
"E00034410",320,35,10,25,285,31,28,58,42,32,30,64
"E00034412",341,98,11,87,243,30,6,48,54,10,22,73
"E00034413",267,29,11,18,238,52,40,37,40,5,16,48
"E00034414",285,23,13,10,262,31,22,79,32,5,23,70
"E00034415",339,89,14,75,250,28,16,36,60,19,33,58
"E00034416",365,28,17,11,337,28,44,50,40,46,32,97
"E00034417",291,35,6,29,256,77,16,41,32,21,14,55
"E00034418",441,25,9,16,416,49,22,122,52,21,58,92
"E00034419",246,38,11,27,208,33,20,31,48,5,11,60
"E00034420",240,35,16,19,205,7,24,35,44,15,26,54
"E00034421",298,48,17,31,250,19,12,61,44,5,29,80
"E00034422",301,51,22,29,250,28,40,53,36,6,30,57
"E00034424",249,39,24,15,210,38,38,19,34,5,18,58
"E00034425",310,59,17,42,251,22,24,68,46,5,14,72
"E00034426",418,109,22,87,309,53,20,64,58,15,27,72
"E00034427",235,80,37,43,155,28,22,25,34,0,18,28
"E00034428",345,40,11,29,305,67,18,67,54,5,29,65
"E00034429",272,75,27,48,197,43,18,30,38,5,23,40
"E00034430",290,66,14,52,224,66,14,48,36,10,6,44
"E00034431",247,34,10,24,213,22,22,60,44,0,24,41
"E00034432",387,57,26,31,330,40,16,85,58,10,59,62
"E00034433",287,29,12,17,258,11,58,61,44,15,20,49
"E00034434",387,24,10,14,363,12,54,70,50,28,32,117
"E00034435",325,37,21,16,288,9,66,48,42,26,28,69
"E00034436",303,67,32,35,236,5,46,41,52,15,26,51
"E00034437",361,70,22,48,291,31,32,50,62,0,53,63
"E00034438",254,42,21,21,212,2,46,52,34,16,19,43
"E00034439",279,60,21,39,219,4,18,45,54,15,10,73
"E00034440",297,52,17,35,245,12,40,57,28,31,9,68
"E00034441",312,29,21,8,283,22,40,83,36,12,35,55
"E00034442",286,59,19,40,227,10,24,40,58,30,10,55
"E00034443",281,46,24,22,235,8,50,52,38,10,4,73
"E00034444",279,34,22,12,245,7,52,51,56,0,17,62
"E00034445",277,32,14,18,245,7,52,38,42,11,25,70
"E00034446",432,63,28,35,369,11,64,86,46,20,49,93
"E00034447",357,18,12,6,339,0,18,98,14,43,58,108
"E00034448",258,25,8,17,233,6,44,65,48,0,12,58
"E00034449",171,42,33,9,129,7,40,14,24,0,15,29
"E00034451",262,80,21,59,182,40,6,34,52,5,5,40
"E00034453",255,76,31,45,179,5,34,35,44,0,23,38
"E00034454",276,163,85,78,113,0,66,0,38,0,0,9
"E00034455",243,25,15,10,218,6,28,56,30,5,12,81
"E00034456",252,17,9,8,235,5,28,48,40,0,34,80
"E00034457",238,22,12,10,216,2,64,22,24,16,24,64
"E00034458",213,38,25,13,175,0,50,28,18,15,17,47
"E00034459",299,36,20,16,263,15,62,41,30,17,24,74
"E00034460",205,38,28,10,167,0,94,19,18,5,14,17
"E00034461",165,77,28,49,88,4,14,10,28,0,16,16
"E00034462",243,33,21,12,210,6,48,29,36,10,18,63
"E00034463",240,17,13,4,223,0,40,41,22,31,24,65
"E00034464",257,31,21,10,226,5,58,24,50,10,14,65
"E00034465",269,28,24,4,241,0,50,29,36,21,22,83
"E00034466",288,41,28,13,247,4,56,54,44,11,15,63
"E00034467",299,19,10,9,280,3,54,73,22,15,29,84
"E00034468",291,32,21,11,259,13,48,43,32,10,41,72
"E00034469",287,10,6,4,277,3,28,90,30,6,46,74
"E00034470",333,18,12,6,315,2,58,43,46,31,47,88
"E00034471",293,37,21,16,256,0,64,47,28,12,34,71
"E00034472",320,70,16,54,250,48,10,44,58,11,22,57
"E00034473",316,35,30,5,281,6,72,48,32,0,51,72
"E00034474",346,109,29,80,237,70,34,34,54,10,9,26
"E00034475",259,61,12,49,198,21,12,30,50,33,14,38
"E00034476",261,63,40,23,198,16,44,45,40,0,30,23
"E00034477",336,37,19,18,299,15,42,80,42,26,47,47
"E00034478",336,124,66,58,212,2,54,53,36,21,13,33
"E00034479",323,33,13,20,290,2,50,60,44,10,34,90
"E00034480",208,107,52,55,101,3,56,11,22,0,0,9
"E00034481",241,80,21,59,161,36,10,22,26,5,19,43
"E00034482",180,95,72,23,85,12,18,25,18,0,4,8
"E00034483",288,66,20,46,222,11,28,36,38,5,33,71
"E00034484",279,74,24,50,205,28,14,24,48,0,12,79
"E00034485",298,38,16,22,260,27,34,52,46,0,49,52
"E00165671",381,64,23,41,317,43,20,49,60,15,31,99
"E00165713",137,13,5,8,124,0,12,31,20,16,15,30
"E00165714",146,11,7,4,135,0,16,24,16,0,37,42
"E00165715",394,72,14,58,322,45,14,43,126,5,28,61
"E00165716",310,70,9,61,240,34,26,32,60,6,32,50
"E00165717",148,31,8,23,117,5,22,8,36,0,15,31
"E00165718",398,56,22,34,342,7,58,61,66,10,38,102
"E00165719",228,90,13,77,138,11,6,26,22,12,31,30
"E00165720",312,32,9,23,280,24,26,36,66,5,37,86
"E00165721",145,10,2,8,135,0,18,37,22,11,24,23
"E00165722",332,71,18,53,261,30,24,52,56,0,10,89
"E00165723",227,24,4,20,203,2,10,67,16,10,22,76
"E00165724",361,50,10,40,311,23,34,68,88,15,21,62
"E00165725",178,21,14,7,157,0,44,11,16,15,41,30
"E00165726",460,79,37,42,381,39,54,54,58,17,60,99
"E00165727",174,34,11,23,140,6,20,36,28,5,13,32
"E00165729",303,43,11,32,260,15,52,27,66,0,27,73
"E00165730",480,39,6,33,441,8,26,121,68,33,88,97
"E00165731",260,21,5,16,239,24,24,30,58,5,20,78
"E00165758",167,13,5,8,154,3,32,24,16,15,19,45
"E00165759",215,30,8,22,185,2,20,22,36,12,24,69
"E00165760",189,100,78,22,89,2,42,6,14,0,4,21
"E00165762",364,54,19,35,310,41,24,56,70,15,40,64
"E00165763",242,46,18,28,196,33,22,40,44,0,13,44
"E00176596",235,70,30,40,165,17,18,38,60,0,15,17
"E00176597",296,57,31,26,239,44,22,25,32,21,55,40
"E00176598",247,17,0,17,230,17,2,94,44,5,27,41
"E00176599",208,33,11,22,175,11,12,39,28,5,37,43
"E00176600",211,49,1,48,162,52,4,44,42,0,4,16
"E00176601",413,24,5,19,389,22,0,206,42,41,44,34
"E00176602",123,46,3,43,77,13,2,7,30,5,4,16
"E00176603",179,58,0,58,121,8,0,9,86,5,0,13
"E00176604",151,54,2,52,97,2,0,8,80,0,0,7
"E00176605",200,57,0,57,143,4,0,21,112,0,0,6
"E00176606",182,64,3,61,118,6,2,15,84,0,0,11
"E00176607",183,34,0,34,149,6,0,14,120,0,0,9
"E00176608",208,71,1,70,137,5,10,7,104,0,0,11
"E00176609",329,61,25,36,268,75,14,35,14,38,40,52
"E00176610",307,106,32,74,201,21,18,19,42,6,32,63
"E00176611",196,6,3,3,190,2,0,4,16,5,17,146
"E00176612",330,27,8,19,303,2,6,13,38,15,23,206
"E00176613",242,24,0,24,218,18,0,13,50,11,5,121
"E00176614",554,29,3,26,525,0,6,4,42,13,38,422
"E00176615",291,185,3,182,106,0,6,30,32,10,4,24
"E00176616",155,71,1,70,84,2,0,7,60,0,0,15
"E00176617",860,788,2,786,72,10,2,9,28,10,0,13
"E00176618",190,32,12,20,158,19,14,6,42,0,22,55
"E00176619",244,64,6,58,180,3,4,17,76,0,0,80
"E00176620",262,69,11,58,193,8,8,7,62,0,11,97
"E00176621",143,49,0,49,94,4,0,15,50,0,0,25
"E00176622",173,50,2,48,123,0,0,11,76,0,0,36
"E00176623",110,29,0,29,81,6,2,19,42,0,0,12
"E00176624",197,63,28,35,134,2,2,10,46,0,5,69
"E00176625",165,70,0,70,95,0,0,11,78,0,0,6
"E00176626",228,95,2,93,133,2,4,14,100,0,0,13
"E00176627",198,57,11,46,141,4,20,19,50,0,15,33
"E00176628",203,51,0,51,152,2,0,20,118,0,0,12
"E00176629",199,70,0,70,129,3,2,14,82,0,4,24
"E00176630",306,38,10,28,268,10,40,39,46,10,31,92
"E00176631",211,20,8,12,191,15,30,35,24,10,33,44
"E00176632",253,23,8,15,230,20,10,85,26,26,16,47
"E00176633",165,28,6,22,137,20,4,19,42,5,16,31
"E00176634",422,276,1,275,146,0,0,3,72,5,0,66
"E00176635",218,62,1,61,156,0,0,7,102,0,0,47
"E00176636",164,86,0,86,78,0,0,0,68,0,0,10
"E00176637",124,71,1,70,53,6,0,0,28,0,5,14
"E00176638",207,83,7,76,124,3,10,9,72,0,0,30
"E00176639",118,64,0,64,54,4,2,3,16,0,0,29
"E00176640",376,73,21,52,303,16,14,88,60,5,14,106
"E00176641",119,56,5,51,63,12,4,10,18,0,16,3
"E00176642",283,97,2,95,186,0,2,16,128,0,0,40
"E00176643",196,75,2,73,121,0,2,9,86,0,0,24
"E00176644",194,57,0,57,137,8,0,15,86,0,0,28
"E00176645",176,69,1,68,107,0,0,9,72,0,5,21
"E00176646",168,72,1,71,96,4,2,3,78,0,4,5
"E00176647",208,64,1,63,144,2,0,14,106,0,0,22
"E00176648",471,60,21,39,411,44,30,67,54,10,90,116
"E00176649",200,69,32,37,131,6,38,13,10,6,23,35
"E00176650",200,63,2,61,137,2,2,32,92,0,0,9
"E00176651",252,32,20,12,220,51,14,54,30,5,23,43
"E00176652",213,86,0,86,127,0,2,6,70,0,5,44
"E00176653",429,96,0,96,333,6,0,44,218,0,0,65
"E00176654",195,77,1,76,118,2,6,19,58,5,8,20
"E00176655",193,70,1,69,123,28,0,15,42,0,4,34
"E00176656",198,85,2,83,113,0,8,12,72,0,0,21
"E00176657",197,85,1,84,112,2,0,4,94,0,0,12
"E00176658",219,68,1,67,151,2,0,3,80,0,4,62
"E00176659",161,75,3,72,86,0,2,0,80,0,0,4
"E00176660",169,59,2,57,110,2,2,12,82,0,0,12
"E00176661",210,16,0,16,194,0,0,25,20,5,17,127
"E00176662",331,36,1,35,295,20,12,86,22,47,44,64
"E00176663",293,59,6,53,234,33,2,47,46,21,33,52
"E00176664",216,35,4,31,181,14,20,21,16,11,44,55
"E00176665",444,91,21,70,353,60,36,60,72,20,59,46
"E00176666",169,39,9,30,130,11,10,28,54,5,7,15
"E00176667",332,88,15,73,244,14,16,49,116,5,10,34
"E00176668",479,69,17,52,410,40,42,78,82,5,63,100
"E00176669",218,51,20,31,167,27,16,29,42,5,16,32
"E00176670",284,66,8,58,218,29,10,44,80,5,27,23
"E00176671",327,63,27,36,264,47,40,30,48,10,26,63
"E00176672",150,47,1,46,103,29,0,15,52,0,0,7
"E00176673",194,63,5,58,131,32,10,35,36,0,12,6
"E00176674",195,54,1,53,141,4,2,6,92,0,0,37
"E00176675",362,152,2,150,210,4,2,22,160,0,4,18
"E00176676",174,74,3,71,100,10,0,26,58,0,0,6
"E00176677",310,30,16,14,280,26,38,53,46,25,37,55
"E00176678",308,36,15,21,272,9,32,59,48,27,53,44
"E00176679",227,100,0,100,127,2,0,10,106,0,0,9
"E00176680",250,101,0,101,149,0,2,17,124,0,0,6
"E00176681",190,64,0,64,126,3,0,15,84,0,5,19
"E00176682",177,90,3,87,87,0,0,6,78,0,0,3
"E00176683",180,63,1,62,117,2,0,6,100,0,0,9
"E00176684",231,59,0,59,172,0,0,20,118,5,0,29
"E00176685",257,40,7,33,217,53,8,33,42,11,24,46
"E00176686",183,85,1,84,98,2,0,8,68,0,0,20
"E00176687",240,74,1,73,166,0,0,3,90,0,0,73
"E00176688",285,84,1,83,201,8,0,4,28,0,0,161
"E00176689",132,31,0,31,101,0,0,0,24,0,8,69
"E00176690",168,57,4,53,111,11,4,0,48,0,4,44
"E00176691",212,37,4,33,175,3,6,4,50,0,4,108
"E00176692",240,63,0,63,177,2,4,15,98,0,4,54
"E00176693",138,39,1,38,99,4,0,4,74,0,0,17
"E00176694",171,83,8,75,88,4,4,10,52,0,0,18
"E00176695",184,69,6,63,115,2,0,11,38,5,0,59
"E00176696",458,49,16,33,409,54,28,93,48,5,73,108
"E00176697",308,51,12,39,257,27,22,53,22,0,56,77
"E00176698",60,31,0,31,29,0,0,3,26,0,0,0
"E00176699",221,74,24,50,147,17,12,26,24,0,8,60
"E00176700",189,61,1,60,128,2,0,4,88,0,0,34
"E00176701",246,74,3,71,172,9,0,28,96,0,5,34
"E00176702",259,19,7,12,240,2,12,17,18,0,7,184
"E00176703",262,21,0,21,241,18,4,105,82,5,8,19
"E00176704",214,48,10,38,166,37,8,34,38,0,18,31
"E00176705",117,45,2,43,72,21,0,9,42,0,0,0
"E00176706",330,32,5,27,298,21,12,110,58,5,37,55
"E00176707",269,43,19,24,226,12,10,28,32,35,28,81
"E00176708",201,37,15,22,164,28,22,29,16,16,31,22
"E00176709",217,120,2,118,97,2,2,39,42,0,0,12
"E00176710",245,102,43,59,143,4,16,8,36,0,4,75
"E00176711",333,41,5,36,292,8,4,6,60,0,4,210
"E00176712",83,41,3,38,42,0,4,22,16,0,0,0
"E00176713",92,25,9,16,67,4,2,19,14,0,4,24
"E00176714",154,49,14,35,105,7,18,20,20,5,12,23
"E00176715",115,62,46,16,53,3,24,4,6,0,6,10
"E00176716",176,57,2,55,119,2,4,13,72,0,8,20
"E00176717",151,58,1,57,93,27,0,14,24,15,0,13
"E00176718",266,29,7,22,237,50,12,22,18,34,83,18
"E00176719",202,60,9,51,142,12,6,35,78,5,0,6
"E00176720",266,44,22,22,222,5,24,75,58,25,21,14
"E00176721",238,63,6,57,175,9,6,66,50,16,13,15
"E00176722",307,22,1,21,285,8,8,114,68,22,9,56
"E00176723",272,26,13,13,246,6,30,53,36,0,37,84
"E00176724",143,32,2,30,111,8,2,6,74,0,0,21
"E00176725",174,68,8,60,106,0,16,21,42,5,4,18
"E00176726",335,55,5,50,280,4,6,21,22,5,23,199
"E00176727",332,58,13,45,274,30,10,64,62,20,20,68
"E00176728",166,38,2,36,128,7,24,17,18,6,8,48
"E00176729",272,28,16,12,244,34,22,89,28,11,27,33
"E00176730",154,43,10,33,111,23,16,12,36,5,10,9
"E00176731",139,43,1,42,96,38,0,21,8,5,10,14
"E00176732",361,43,14,29,318,56,18,47,36,30,24,107
"E00176733",202,89,5,84,113,15,2,3,38,0,34,21
"E00176734",109,23,0,23,86,2,2,7,62,0,0,13
"E00176735",197,70,0,70,127,7,0,7,92,0,0,21
"E00176736",215,46,1,45,169,3,2,7,134,0,7,16
"E00176737",185,53,1,52,132,0,0,0,102,0,0,30
"E00176738",111,36,9,27,75,12,4,17,10,0,13,19
"E00176739",213,42,0,42,171,0,0,0,152,0,0,19
"E00176740",156,86,1,85,70,0,0,16,54,0,0,0
"E00176741",225,55,26,29,170,28,32,11,26,15,20,38
"E00176742",205,44,3,41,161,43,0,31,56,10,10,11
"E00176743",230,38,1,37,192,41,2,56,66,5,4,18
"E00176744",158,13,3,10,145,24,2,20,14,8,21,56
"E00176745",265,33,5,28,232,30,10,57,56,21,18,40
"E00176746",563,198,35,163,365,33,22,63,114,10,79,44
"E00176747",138,14,3,11,124,10,6,15,24,12,26,31
"E00176748",191,49,0,49,142,5,0,3,98,0,0,36
"E00176749",247,83,0,83,164,2,0,10,118,0,0,34
"E00176750",243,54,20,34,189,28,16,61,24,10,4,46
"E00176751",226,52,9,43,174,23,12,52,58,0,9,20
"E00176752",280,71,12,59,209,20,24,27,60,5,12,61
"E00176753",231,31,5,26,200,72,8,27,20,10,43,20
"E00176754",244,95,33,62,149,26,18,25,22,17,14,27
"E00176755",280,61,20,41,219,31,18,42,36,10,32,50
"E00176756",206,73,1,72,133,2,0,9,110,0,0,12
"E00176757",200,83,10,73,117,2,6,12,72,0,0,25
"E00176758",104,32,4,28,72,14,8,7,10,8,4,21
"E00176759",248,32,6,26,216,56,12,56,24,11,20,37
"E00176760",177,27,7,20,150,40,20,15,14,16,16,29
"E00176761",230,32,2,30,198,34,8,79,32,15,12,18
"E00176762",217,35,10,25,182,50,4,46,14,11,17,40
"E00176763",111,7,1,6,104,22,4,57,8,5,5,3
"E00176764",257,38,9,29,219,43,16,65,44,21,10,20
"E00176765",230,40,1,39,190,41,2,45,50,0,14,38
"E00176766",173,70,1,69,103,0,0,7,84,0,0,12
"E00176767",211,29,16,13,182,16,24,40,32,0,19,51
"E00176768",362,79,33,46,283,10,60,37,46,5,60,65
"E00176769",162,63,0,63,99,2,2,6,86,0,0,3
"E00176770",156,12,1,11,144,24,12,34,16,10,18,30
"E00176771",124,8,7,1,116,0,12,44,8,0,13,39
"E00176772",252,20,10,10,232,0,38,44,36,16,24,74
"E00176773",169,68,4,64,101,19,2,28,34,5,4,9
"E00176774",102,25,18,7,77,7,12,7,14,10,8,19
