"GeographyCode","QS403EW0001","QS403EW0002","QS403EW0003","QS403EW0004","QS403EW0005","QS403EW0006","QS403EW0007","QS403EW0008","QS403EW0009","QS403EW0010","QS403EW0011","QS403EW0012","QS403EW0013","QS403EW0014"
"E00032987",198,10,0,10,0,121,5,116,65,65,0,0,0,2
"E00032988",298,43,25,18,0,183,3,180,72,70,0,0,2,0
"E00032989",333,31,6,25,0,225,7,218,77,73,0,2,2,0
"E00032990",326,43,13,30,26,164,8,156,92,86,0,6,0,1
"E00032991",320,25,12,13,0,192,8,184,100,92,0,5,3,3
"E00032992",240,21,12,9,0,177,8,169,41,34,0,7,0,1
"E00032993",282,58,18,40,2,99,24,75,119,106,0,10,3,4
"E00032994",111,10,0,10,0,75,32,43,23,17,0,6,0,3
"E00032995",268,79,49,30,0,126,11,115,59,53,0,6,0,4
"E00032996",417,68,11,57,0,334,128,206,7,5,0,0,2,8
"E00032997",211,87,39,48,3,65,1,64,53,44,0,9,0,3
"E00032998",337,87,32,55,0,148,32,116,97,94,0,3,0,5
"E00032999",359,20,15,5,0,183,9,174,153,148,0,5,0,3
"E00033000",177,13,0,13,0,157,9,148,5,5,0,0,0,2
"E00033002",227,61,25,36,0,95,10,85,62,52,0,8,2,9
"E00033004",252,154,66,88,0,7,0,7,89,82,2,2,3,2
"E00033005",336,59,19,40,2,240,35,205,29,26,0,0,3,6
"E00033006",271,93,45,48,0,118,7,111,60,59,0,1,0,0
"E00033007",317,18,3,15,24,235,26,209,30,27,0,0,3,10
"E00033008",345,51,6,45,2,259,102,157,29,28,0,0,1,4
"E00033012",149,118,62,56,0,1,0,1,28,21,0,3,4,2
"E00033013",202,53,28,25,0,75,4,71,73,71,0,1,1,1
"E00033015",209,40,19,21,4,4,0,4,155,146,0,9,0,6
"E00033016",448,128,51,77,6,52,2,50,259,245,0,6,8,3
"E00033018",140,11,7,4,6,54,0,54,69,69,0,0,0,0
"E00033019",350,6,2,4,2,213,7,206,129,126,3,0,0,0
"E00033020",231,19,2,17,6,61,3,58,144,125,1,9,9,1
"E00033021",262,25,11,14,42,162,21,141,30,18,0,5,7,3
"E00033023",298,35,20,15,0,157,8,149,93,89,3,0,1,13
"E00033024",178,26,8,18,0,134,42,92,14,13,0,0,1,4
"E00033025",265,201,79,122,0,27,0,27,35,30,0,5,0,2
"E00033026",219,213,77,136,0,0,0,0,1,1,0,0,0,5
"E00033027",366,155,69,86,0,26,0,26,185,178,0,5,2,0
"E00033029",240,134,59,75,3,15,0,15,87,78,3,6,0,1
"E00033030",240,208,93,115,0,5,5,0,27,24,0,3,0,0
"E00033031",309,253,86,167,3,9,4,5,44,38,0,6,0,0
"E00033032",347,59,23,36,0,45,2,43,239,233,0,5,1,4
"E00033033",288,61,11,50,0,39,0,39,186,180,0,6,0,2
"E00033034",313,110,34,76,0,13,0,13,189,182,0,7,0,1
"E00033035",324,108,39,69,1,124,0,124,90,88,0,2,0,1
"E00033036",191,45,16,29,1,79,0,79,66,61,0,5,0,0
"E00033037",276,188,123,65,0,6,0,6,81,79,0,2,0,1
"E00033038",166,32,9,23,0,44,1,43,83,78,0,5,0,7
"E00033040",270,127,40,87,10,44,4,40,89,82,0,7,0,0
"E00033041",262,252,93,159,0,2,0,2,8,8,0,0,0,0
"E00033042",239,211,94,117,0,2,0,2,26,24,2,0,0,0
"E00033043",252,174,66,108,0,4,0,4,73,63,3,7,0,1
"E00033044",239,208,107,101,0,0,0,0,27,15,0,0,12,4
"E00033045",215,11,7,4,0,189,0,189,15,14,0,1,0,0
"E00033046",180,134,107,27,0,7,0,7,37,37,0,0,0,2
"E00033047",282,268,98,170,0,10,0,10,3,3,0,0,0,1
"E00033048",252,234,107,127,0,7,7,0,11,9,0,2,0,0
"E00033049",372,255,58,197,4,5,0,5,106,106,0,0,0,2
"E00033050",227,224,81,143,0,3,3,0,0,0,0,0,0,0
"E00033051",308,142,51,91,0,10,2,8,151,146,0,3,2,5
"E00033052",377,172,63,109,0,21,0,21,182,180,0,2,0,2
"E00033053",278,201,51,150,0,10,2,8,67,63,0,4,0,0
"E00033054",158,68,21,47,0,87,0,87,3,3,0,0,0,0
"E00033055",244,198,40,158,0,7,0,7,37,28,0,3,6,2
"E00033056",278,231,62,169,0,4,0,4,43,41,0,2,0,0
"E00033057",292,211,85,126,0,12,2,10,69,49,0,20,0,0
"E00033059",307,193,65,128,0,77,2,75,29,27,0,0,2,8
"E00033060",204,177,102,75,0,0,0,0,18,14,0,2,2,9
"E00033061",235,200,78,122,1,12,0,12,22,21,0,1,0,0
"E00033062",264,255,106,149,0,2,2,0,6,6,0,0,0,1
"E00033063",259,246,115,131,0,5,0,5,8,8,0,0,0,0
"E00033064",235,220,82,138,0,0,0,0,15,13,0,2,0,0
"E00033065",293,263,95,168,0,13,6,7,17,17,0,0,0,0
"E00033066",242,76,17,59,0,65,0,65,101,99,0,2,0,0
"E00033067",279,76,25,51,0,56,0,56,147,145,2,0,0,0
"E00033068",327,95,35,60,0,12,2,10,218,212,0,6,0,2
"E00033069",248,44,15,29,2,54,0,54,146,136,0,10,0,2
"E00033070",263,56,20,36,0,111,8,103,93,84,0,3,6,3
"E00033071",261,134,48,86,0,40,2,38,87,83,0,4,0,0
"E00033072",275,55,13,42,2,66,5,61,148,141,2,3,2,4
"E00033073",253,23,2,21,1,56,0,56,172,166,0,5,1,1
"E00033074",283,36,6,30,2,172,11,161,73,59,0,14,0,0
"E00033075",237,16,4,12,0,179,9,170,41,35,0,4,2,1
"E00033076",302,235,115,120,0,5,4,1,55,53,0,0,2,7
"E00033077",292,86,31,55,2,68,0,68,134,127,0,7,0,2
"E00033078",272,138,77,61,0,69,3,66,63,60,0,3,0,2
"E00033079",230,122,45,77,0,35,1,34,73,69,0,4,0,0
"E00033080",197,22,7,15,0,164,4,160,10,10,0,0,0,1
"E00033081",220,155,48,107,2,18,1,17,42,41,0,1,0,3
"E00033082",312,298,151,147,0,9,0,9,5,1,0,1,3,0
"E00033083",336,309,142,167,0,0,0,0,26,25,0,1,0,1
"E00033084",325,220,83,137,0,77,1,76,22,18,4,0,0,6
"E00033085",321,229,97,132,0,43,14,29,46,42,0,4,0,3
"E00033086",249,243,128,115,0,0,0,0,6,6,0,0,0,0
"E00033087",397,319,100,219,0,41,9,32,34,34,0,0,0,3
"E00033088",239,168,72,96,3,51,10,41,13,11,0,2,0,4
"E00033089",302,195,59,136,0,75,19,56,26,23,0,3,0,6
"E00033090",376,253,71,182,0,108,41,67,15,15,0,0,0,0
"E00033091",306,282,112,170,0,12,3,9,6,5,0,1,0,6
"E00033092",307,292,136,156,0,0,0,0,15,14,0,1,0,0
"E00033093",372,289,86,203,2,23,10,13,55,50,0,5,0,3
"E00033094",328,262,122,140,0,29,10,19,37,34,0,3,0,0
"E00033095",414,351,150,201,0,8,3,5,50,41,2,7,0,5
"E00033096",259,251,127,124,0,0,0,0,8,7,0,1,0,0
"E00033097",263,128,45,83,0,118,34,84,17,17,0,0,0,0
"E00033098",274,249,109,140,0,4,0,4,21,19,0,2,0,0
"E00033099",163,95,42,53,1,63,9,54,3,3,0,0,0,1
"E00033100",297,184,61,123,0,82,20,62,29,17,0,12,0,2
"E00033101",212,201,110,91,4,2,0,2,4,4,0,0,0,1
"E00033102",429,313,95,218,3,49,10,39,56,52,0,4,0,8
"E00033103",298,191,59,132,0,83,16,67,19,19,0,0,0,5
"E00033104",275,178,70,108,0,60,31,29,36,34,0,2,0,1
"E00033105",293,284,137,147,0,1,0,1,6,5,0,1,0,2
"E00033106",286,143,44,99,0,109,31,78,27,26,0,1,0,7
"E00033107",353,295,109,186,0,25,5,20,30,25,0,0,5,3
"E00033108",317,224,69,155,0,59,25,34,32,32,0,0,0,2
"E00033109",322,286,130,156,4,0,0,0,31,28,0,3,0,1
"E00033110",340,294,116,178,0,10,3,7,36,36,0,0,0,0
"E00033112",308,302,130,172,0,0,0,0,6,6,0,0,0,0
"E00033113",246,210,102,108,0,2,0,2,34,34,0,0,0,0
"E00033114",303,296,132,164,0,7,0,7,0,0,0,0,0,0
"E00033115",132,105,66,39,1,1,0,1,25,20,0,5,0,0
"E00033116",137,81,64,17,0,37,4,33,18,16,2,0,0,1
"E00033117",385,341,117,224,0,25,0,25,16,14,0,2,0,3
"E00033118",331,312,135,177,0,4,0,4,14,10,0,4,0,1
"E00033119",262,244,109,135,0,0,0,0,17,13,0,4,0,1
"E00033120",313,265,93,172,6,3,0,3,39,38,0,1,0,0
"E00033121",220,176,97,79,1,31,4,27,6,6,0,0,0,6
"E00033122",275,238,120,118,2,10,2,8,19,18,0,1,0,6
"E00033123",258,247,145,102,0,4,0,4,3,2,0,1,0,4
"E00033124",307,275,102,173,0,16,0,16,14,14,0,0,0,2
"E00033125",187,84,24,60,0,87,19,68,14,14,0,0,0,2
"E00033126",251,234,117,117,0,8,4,4,9,7,0,2,0,0
"E00033127",435,282,71,211,0,88,20,68,51,47,0,4,0,14
"E00033128",268,161,49,112,0,92,9,83,8,2,0,0,6,7
"E00033129",256,229,126,103,0,0,0,0,26,25,0,1,0,1
"E00033130",360,346,135,211,0,0,0,0,14,14,0,0,0,0
"E00033131",275,172,65,107,0,85,16,69,17,10,0,7,0,1
"E00033132",419,319,112,207,1,11,0,11,81,73,0,8,0,7
"E00033133",366,31,13,18,0,322,12,310,9,9,0,0,0,4
"E00033134",190,81,39,42,0,28,10,18,76,71,0,5,0,5
"E00033135",445,231,78,153,0,19,9,10,194,190,2,1,1,1
"E00033136",225,103,50,53,2,55,2,53,53,47,0,6,0,12
"E00033137",280,79,35,44,0,105,5,100,96,81,0,11,4,0
"E00033138",171,39,27,12,1,42,0,42,85,82,1,2,0,4
"E00033139",248,123,66,57,0,95,8,87,29,18,0,11,0,1
"E00033140",202,138,57,81,0,4,3,1,60,58,0,2,0,0
"E00033141",208,127,77,50,1,5,5,0,75,65,0,10,0,0
"E00033142",273,174,53,121,0,1,0,1,90,83,0,6,1,8
"E00033143",261,88,30,58,0,20,3,17,150,148,0,2,0,3
"E00033144",204,68,39,29,0,14,5,9,118,116,0,2,0,4
"E00033145",294,184,69,115,0,9,2,7,92,86,0,0,6,9
"E00033146",304,174,59,115,2,9,0,9,119,117,0,2,0,0
"E00033147",308,254,103,151,0,8,0,8,40,40,0,0,0,6
"E00033148",258,162,60,102,0,4,0,4,89,89,0,0,0,3
"E00033149",226,103,52,51,2,19,3,16,102,100,0,2,0,0
"E00033150",316,132,48,84,0,11,1,10,165,165,0,0,0,8
"E00033151",262,85,41,44,0,68,8,60,104,104,0,0,0,5
"E00033152",305,121,49,72,4,32,9,23,146,137,0,5,4,2
"E00033153",332,219,102,117,0,3,2,1,108,103,0,5,0,2
"E00033154",156,40,30,10,1,28,8,20,87,87,0,0,0,0
"E00033155",266,144,65,79,0,6,0,6,111,105,0,6,0,5
"E00033156",238,91,50,41,0,41,0,41,104,98,0,6,0,2
"E00033157",326,121,53,68,0,40,2,38,162,158,0,0,4,3
"E00033158",302,113,30,83,0,59,3,56,128,125,0,3,0,2
"E00033159",197,49,21,28,0,81,27,54,59,57,0,0,2,8
"E00033160",354,124,61,63,0,87,4,83,126,104,0,16,6,17
"E00033161",280,157,36,121,2,70,0,70,50,48,0,2,0,1
"E00033162",280,31,13,18,0,133,5,128,105,99,0,5,1,11
"E00033163",277,40,14,26,0,97,3,94,128,126,0,0,2,12
"E00033164",351,247,77,170,0,5,0,5,98,89,0,7,2,1
"E00033165",166,56,15,41,0,87,25,62,17,17,0,0,0,6
"E00033166",158,75,55,20,0,72,24,48,8,8,0,0,0,3
"E00033167",310,211,69,142,0,9,0,9,90,85,0,0,5,0
"E00033168",285,239,103,136,0,10,3,7,36,34,0,2,0,0
"E00033169",302,258,97,161,0,5,4,1,34,29,0,5,0,5
"E00033170",360,307,101,206,2,5,0,5,45,41,0,4,0,1
"E00033171",345,289,83,206,1,15,0,15,40,38,0,2,0,0
"E00033172",186,43,22,21,0,93,0,93,50,49,0,1,0,0
"E00033173",315,258,91,167,0,28,0,28,25,23,0,2,0,4
"E00033174",297,32,12,20,0,244,24,220,19,16,0,3,0,2
"E00033175",279,178,59,119,4,74,23,51,20,20,0,0,0,3
"E00033176",264,99,34,65,0,84,0,84,81,76,0,5,0,0
"E00033177",298,232,74,158,0,11,9,2,52,52,0,0,0,3
"E00033178",170,71,29,42,5,42,0,42,46,44,0,2,0,6
"E00033179",322,97,23,74,0,163,25,138,57,54,0,3,0,5
"E00033181",421,154,53,101,0,36,2,34,231,229,0,2,0,0
"E00033182",368,96,41,55,8,84,1,83,172,172,0,0,0,8
"E00033183",584,120,46,74,4,39,0,39,421,419,0,2,0,0
"E00033185",340,112,38,74,0,1,0,1,227,224,0,0,3,0
"E00033186",318,78,26,52,6,21,1,20,213,210,0,2,1,0
"E00033187",197,67,28,39,3,28,0,28,98,95,1,2,0,1
"E00033188",327,127,61,66,7,45,7,38,148,132,0,14,2,0
"E00033189",509,81,48,33,0,247,4,243,150,133,1,13,3,31
"E00033190",574,96,49,47,0,270,29,241,179,158,0,8,13,29
"E00033191",448,96,56,40,4,31,6,25,313,300,0,13,0,4
"E00033192",434,67,25,42,0,16,0,16,347,334,0,10,3,4
"E00033193",327,138,55,83,0,10,0,10,175,162,0,11,2,4
"E00033194",345,88,31,57,8,34,0,34,205,180,0,25,0,10
"E00033195",249,116,34,82,4,5,1,4,122,115,0,7,0,2
"E00033196",210,30,11,19,0,45,10,35,134,134,0,0,0,1
"E00033197",355,77,26,51,6,224,3,221,44,42,0,2,0,4
"E00033198",393,154,59,95,5,13,0,13,221,221,0,0,0,0
"E00033199",185,24,19,5,1,150,3,147,8,8,0,0,0,2
"E00033200",232,22,8,14,1,120,4,116,87,87,0,0,0,2
"E00033201",235,96,32,64,0,19,0,19,120,110,0,10,0,0
"E00033202",315,113,32,81,0,16,0,16,184,173,0,11,0,2
"E00033203",244,138,64,74,0,8,0,8,98,94,0,4,0,0
"E00033204",252,129,55,74,0,2,0,2,119,106,0,11,2,2
"E00033206",184,43,21,22,0,61,1,60,73,63,10,0,0,7
"E00033207",293,28,15,13,0,155,7,148,96,92,4,0,0,14
"E00033208",257,21,12,9,1,117,11,106,106,96,0,2,8,12
"E00033209",323,36,17,19,0,192,28,164,88,78,6,4,0,7
"E00033210",271,42,16,26,4,86,4,82,136,133,0,0,3,3
"E00033211",357,100,59,41,0,143,14,129,101,96,0,2,3,13
"E00033212",314,68,30,38,15,144,4,140,86,86,0,0,0,1
"E00033213",401,124,80,44,7,0,0,0,265,258,0,7,0,5
"E00033214",538,112,70,42,4,186,6,180,234,213,4,6,11,2
"E00033215",349,53,25,28,10,165,18,147,120,109,9,0,2,1
"E00033216",252,62,17,45,17,93,6,87,80,80,0,0,0,0
"E00033217",287,89,60,29,0,30,1,29,165,165,0,0,0,3
"E00033218",303,209,79,130,0,20,0,20,73,73,0,0,0,1
"E00033219",362,120,45,75,0,59,2,57,182,173,0,9,0,1
"E00033220",389,75,28,47,0,10,0,10,304,286,0,18,0,0
"E00033221",249,11,2,9,0,95,9,86,140,140,0,0,0,3
"E00033222",178,2,1,1,0,151,8,143,25,21,0,4,0,0
"E00033223",248,23,8,15,5,59,2,57,161,160,0,0,1,0
"E00033224",301,55,17,38,9,199,11,188,30,30,0,0,0,8
"E00033225",300,52,21,31,5,170,6,164,67,62,0,5,0,6
"E00033226",417,76,41,35,4,258,24,234,70,70,0,0,0,9
"E00033227",262,21,11,10,0,214,1,213,27,27,0,0,0,0
"E00033228",341,59,17,42,4,174,34,140,100,100,0,0,0,4
"E00033229",284,236,121,115,0,16,7,9,31,28,0,3,0,1
"E00033230",279,231,143,88,0,18,1,17,30,28,0,2,0,0
"E00033231",203,71,46,25,0,67,16,51,62,62,0,0,0,3
"E00033235",228,57,22,35,2,134,10,124,30,26,0,4,0,5
"E00033237",276,19,6,13,0,244,16,228,13,13,0,0,0,0
"E00033238",463,108,60,48,0,308,12,296,45,43,0,1,1,2
"E00033242",233,63,18,45,0,170,56,114,0,0,0,0,0,0
"E00033245",315,69,30,39,0,209,28,181,35,32,0,3,0,2
"E00033246",253,103,46,57,0,95,12,83,54,54,0,0,0,1
"E00033247",333,135,75,60,0,103,5,98,91,89,0,1,1,4
"E00033248",294,8,5,3,3,271,83,188,6,5,0,0,1,6
"E00033249",285,106,38,68,0,121,16,105,57,54,0,3,0,1
"E00033250",226,48,30,18,0,120,11,109,55,52,0,0,3,3
"E00033251",222,29,10,19,0,133,9,124,60,60,0,0,0,0
"E00033252",350,49,31,18,1,266,32,234,31,31,0,0,0,3
"E00033253",240,54,18,36,5,123,17,106,56,55,0,1,0,2
"E00033254",358,99,49,50,0,215,31,184,39,32,4,3,0,5
"E00033255",267,141,56,85,0,111,30,81,13,9,0,4,0,2
"E00033256",225,143,71,72,6,48,19,29,25,12,0,9,4,3
"E00033257",308,159,81,78,0,84,34,50,57,57,0,0,0,8
"E00033258",325,35,15,20,0,265,88,177,14,13,0,0,1,11
"E00033259",135,42,14,28,0,53,3,50,40,40,0,0,0,0
"E00033260",245,86,49,37,2,87,7,80,70,70,0,0,0,0
"E00033261",247,79,34,45,0,100,14,86,66,66,0,0,0,2
"E00033262",154,40,34,6,1,29,0,29,78,77,0,1,0,6
"E00033263",145,33,18,15,0,48,0,48,55,55,0,0,0,9
"E00033264",279,76,40,36,0,173,32,141,27,23,0,3,1,3
"E00033265",298,147,61,86,0,139,35,104,12,12,0,0,0,0
"E00033266",314,208,82,126,0,83,27,56,20,20,0,0,0,3
"E00033267",250,84,24,60,3,99,1,98,57,55,0,2,0,7
"E00033268",291,227,93,134,3,36,18,18,22,22,0,0,0,3
"E00033269",168,121,42,79,0,36,10,26,6,6,0,0,0,5
"E00033270",345,289,90,199,0,22,5,17,32,28,0,4,0,2
"E00033271",379,350,99,251,0,4,4,0,24,24,0,0,0,1
"E00033272",301,271,111,160,0,12,3,9,18,18,0,0,0,0
"E00033274",259,175,49,126,0,58,24,34,25,24,0,0,1,1
"E00033275",286,195,48,147,1,82,6,76,8,6,0,2,0,0
"E00033276",225,108,24,84,0,56,10,46,50,46,0,4,0,11
"E00033277",224,113,51,62,0,87,24,63,24,24,0,0,0,0
"E00033278",225,145,51,94,0,22,0,22,55,49,0,0,6,3
"E00033279",276,134,40,94,1,60,0,60,81,79,2,0,0,0
"E00033281",307,193,69,124,2,35,0,35,69,66,0,3,0,8
"E00033282",303,206,67,139,0,58,10,48,37,37,0,0,0,2
"E00033283",276,205,82,123,0,61,12,49,10,10,0,0,0,0
"E00033284",250,24,12,12,0,192,51,141,28,23,0,5,0,6
"E00033285",300,200,82,118,0,44,3,41,55,55,0,0,0,1
"E00033286",218,66,36,30,0,118,20,98,33,33,0,0,0,1
"E00033287",306,248,57,191,0,17,16,1,41,37,0,4,0,0
"E00033288",321,282,81,201,0,2,0,2,37,31,0,0,6,0
"E00033289",229,207,67,140,0,1,0,1,16,8,0,5,3,5
"E00033290",242,218,45,173,0,10,1,9,14,14,0,0,0,0
"E00033291",498,359,77,282,0,56,13,43,83,77,1,5,0,0
"E00033292",203,174,62,112,1,8,1,7,20,16,2,2,0,0
"E00033293",319,148,32,116,21,120,13,107,30,27,0,3,0,0
"E00033294",232,81,35,46,1,34,3,31,115,107,0,3,5,1
"E00033295",283,250,86,164,0,10,0,10,22,20,0,2,0,1
"E00033296",268,235,95,140,0,1,0,1,30,28,1,0,1,2
"E00033297",312,148,44,104,16,114,19,95,32,29,0,3,0,2
"E00033298",294,181,55,126,0,96,45,51,10,10,0,0,0,7
"E00033299",288,227,96,131,0,41,7,34,14,11,0,2,1,6
"E00033300",234,141,48,93,3,67,17,50,22,22,0,0,0,1
"E00033301",300,120,25,95,0,141,34,107,38,34,0,4,0,1
"E00033302",239,94,35,59,0,134,43,91,11,11,0,0,0,0
"E00033304",252,162,60,102,0,51,15,36,38,34,0,0,4,1
"E00033305",276,187,69,118,5,72,20,52,9,9,0,0,0,3
"E00033306",280,137,66,71,0,111,36,75,26,17,0,3,6,6
"E00033307",312,110,30,80,0,175,41,134,22,22,0,0,0,5
"E00033308",288,152,44,108,0,102,29,73,34,34,0,0,0,0
"E00033309",316,98,30,68,0,168,53,115,47,47,0,0,0,3
"E00033310",331,136,50,86,0,161,28,133,34,31,0,3,0,0
"E00033312",276,143,72,71,0,106,23,83,23,22,0,0,1,4
"E00033313",340,138,56,82,0,178,42,136,16,16,0,0,0,8
"E00033314",316,232,70,162,0,71,13,58,11,6,0,1,4,2
"E00033315",354,233,92,141,0,93,33,60,16,9,0,6,1,12
"E00033316",327,286,98,188,0,4,0,4,32,31,0,1,0,5
"E00033317",368,321,101,220,0,20,0,20,22,22,0,0,0,5
"E00033318",355,166,42,124,0,150,44,106,35,30,0,5,0,4
"E00033319",419,386,144,242,0,3,0,3,25,23,0,2,0,5
"E00033320",292,278,119,159,0,0,0,0,14,10,0,4,0,0
"E00033322",301,283,121,162,0,7,6,1,8,8,0,0,0,3
"E00033323",297,291,144,147,0,0,0,0,6,1,0,5,0,0
"E00033324",304,284,103,181,0,5,5,0,15,15,0,0,0,0
"E00033326",293,285,118,167,0,0,0,0,4,4,0,0,0,4
"E00033327",295,282,105,177,0,0,0,0,13,13,0,0,0,0
"E00033328",264,116,28,88,0,122,30,92,20,20,0,0,0,6
"E00033329",316,279,92,187,0,4,0,4,30,26,0,0,4,3
"E00033330",320,300,127,173,0,2,2,0,18,18,0,0,0,0
"E00033331",328,299,116,183,0,8,0,8,21,17,0,4,0,0
"E00033332",314,291,96,195,0,1,0,1,19,18,0,1,0,3
"E00033333",341,323,124,199,0,6,6,0,12,8,0,4,0,0
"E00033334",294,262,109,153,0,4,0,4,27,26,0,1,0,1
"E00033335",252,244,116,128,0,1,0,1,7,7,0,0,0,0
"E00033336",328,300,117,183,0,5,5,0,23,22,0,1,0,0
"E00033337",200,186,78,108,0,3,0,3,9,9,0,0,0,2
"E00033338",274,263,95,168,0,4,0,4,5,5,0,0,0,2
"E00033339",353,302,109,193,0,7,0,7,40,37,0,3,0,4
"E00033340",305,301,83,218,0,0,0,0,4,0,0,0,4,0
"E00033341",309,297,111,186,0,4,0,4,8,8,0,0,0,0
"E00033342",324,306,148,158,0,6,5,1,12,12,0,0,0,0
"E00033343",264,247,76,171,0,0,0,0,14,10,0,4,0,3
"E00033344",332,286,112,174,0,4,0,4,42,28,12,2,0,0
"E00033345",384,355,131,224,3,8,0,8,14,14,0,0,0,4
"E00033346",289,212,88,124,0,5,0,5,69,64,1,4,0,3
"E00033347",315,278,123,155,0,2,0,2,32,29,0,3,0,3
"E00033348",289,263,93,170,0,6,3,3,13,4,0,9,0,7
"E00033349",267,141,54,87,8,65,6,59,53,52,0,0,1,0
"E00033350",322,303,127,176,0,3,0,3,16,16,0,0,0,0
"E00033351",300,188,82,106,0,87,38,49,16,13,0,3,0,9
"E00033352",255,211,75,136,0,7,0,7,35,33,0,1,1,2
"E00033353",254,224,91,133,0,4,4,0,24,23,0,0,1,2
"E00033354",214,44,16,28,0,147,30,117,12,12,0,0,0,11
"E00033355",275,226,53,173,0,1,0,1,48,48,0,0,0,0
"E00033356",345,292,92,200,2,31,9,22,19,19,0,0,0,1
"E00033357",266,133,63,70,4,108,46,62,19,18,0,1,0,2
"E00033358",221,112,52,60,0,70,35,35,35,32,0,0,3,4
"E00033359",324,215,78,137,3,16,8,8,88,87,0,1,0,2
"E00033360",354,286,141,145,0,36,14,22,27,23,0,4,0,5
"E00033361",429,362,96,266,0,9,0,9,57,56,0,0,1,1
"E00033362",272,245,51,194,0,1,0,1,26,21,0,5,0,0
"E00033363",196,160,39,121,0,3,0,3,33,31,0,1,1,0
"E00033364",362,334,148,186,0,5,5,0,22,9,0,13,0,1
"E00033365",448,384,135,249,0,3,2,1,55,55,0,0,0,6
"E00033366",284,262,129,133,0,0,0,0,22,22,0,0,0,0
"E00033367",336,202,58,144,0,9,0,9,125,119,0,5,1,0
"E00033368",269,187,73,114,0,5,0,5,76,69,0,7,0,1
"E00033369",373,336,114,222,0,6,0,6,30,30,0,0,0,1
"E00033370",272,188,65,123,2,34,0,34,43,37,0,6,0,5
"E00033371",308,265,103,162,0,4,0,4,39,39,0,0,0,0
"E00033372",291,231,69,162,1,4,1,3,54,54,0,0,0,1
"E00033373",474,393,155,238,2,17,0,17,62,59,0,3,0,0
"E00033374",275,202,87,115,2,6,0,6,61,57,0,4,0,4
"E00033375",347,304,152,152,0,0,0,0,39,39,0,0,0,4
"E00033376",281,259,135,124,0,5,0,5,12,9,0,3,0,5
"E00033377",306,258,97,161,0,3,0,3,44,42,0,2,0,1
"E00033378",334,294,124,170,0,5,0,5,35,30,0,5,0,0
"E00033379",273,194,61,133,0,1,0,1,78,71,0,7,0,0
"E00033380",246,211,79,132,0,6,2,4,29,29,0,0,0,0
"E00033381",208,181,120,61,3,2,1,1,19,19,0,0,0,3
"E00033382",332,297,90,207,0,9,0,9,26,26,0,0,0,0
"E00033383",281,225,90,135,0,0,0,0,56,37,0,19,0,0
"E00033384",356,293,121,172,0,4,0,4,53,50,0,3,0,6
"E00033385",317,224,87,137,0,10,1,9,83,76,0,5,2,0
"E00033386",352,266,81,185,2,44,0,44,40,40,0,0,0,0
"E00033387",214,95,42,53,0,41,8,33,78,76,0,2,0,0
"E00033388",288,63,21,42,14,171,3,168,37,32,0,5,0,3
"E00033389",278,235,63,172,0,22,5,17,20,13,0,1,6,1
"E00033391",346,167,61,106,5,59,10,49,114,108,0,6,0,1
"E00033392",285,122,44,78,0,29,7,22,128,120,0,8,0,6
"E00033394",284,136,39,97,0,53,12,41,95,93,0,1,1,0
"E00033395",287,120,61,59,0,17,5,12,149,143,0,5,1,1
"E00033396",285,228,114,114,0,10,0,10,40,36,0,4,0,7
"E00033397",323,291,66,225,0,12,5,7,15,15,0,0,0,5
"E00033399",330,298,104,194,0,2,0,2,30,22,0,8,0,0
"E00033400",299,292,94,198,0,3,0,3,4,4,0,0,0,0
"E00033401",275,245,77,168,0,6,0,6,22,22,0,0,0,2
"E00033402",346,174,66,108,7,21,2,19,144,138,0,6,0,0
"E00033403",348,289,113,176,0,1,0,1,53,51,0,2,0,5
"E00033404",329,170,81,89,0,28,1,27,127,108,3,16,0,4
"E00033405",305,254,84,170,3,4,4,0,41,39,0,2,0,3
"E00033406",321,275,98,177,0,0,0,0,42,42,0,0,0,4
"E00033407",328,148,66,82,2,11,2,9,165,164,0,1,0,2
"E00033408",327,188,57,131,0,7,3,4,132,118,0,10,4,0
"E00033409",314,265,171,94,1,5,0,5,38,36,2,0,0,5
"E00033410",289,193,64,129,0,6,0,6,90,88,0,2,0,0
"E00033411",330,308,127,181,0,1,0,1,21,21,0,0,0,0
"E00033412",345,207,74,133,0,2,0,2,135,135,0,0,0,1
"E00033413",242,96,40,56,0,9,0,9,137,134,0,3,0,0
"E00033414",330,190,63,127,0,8,0,8,127,123,0,2,2,5
"E00033415",274,254,78,176,0,10,0,10,7,7,0,0,0,3
"E00033416",359,186,48,138,0,13,0,13,160,152,0,6,2,0
"E00033417",339,244,81,163,0,5,0,5,88,77,0,7,4,2
"E00033418",424,392,159,233,0,10,2,8,21,19,0,0,2,1
"E00033419",308,289,128,161,0,6,2,4,12,12,0,0,0,1
"E00033420",388,214,84,130,0,12,5,7,156,153,0,3,0,6
"E00033421",309,180,49,131,0,0,0,0,128,122,0,6,0,1
"E00033422",467,426,172,254,0,9,7,2,32,32,0,0,0,0
"E00033423",315,213,57,156,0,1,0,1,101,101,0,0,0,0
"E00033424",304,220,73,147,0,6,1,5,74,71,0,3,0,4
"E00033425",245,172,48,124,0,8,0,8,63,59,0,4,0,2
"E00033426",302,239,98,141,0,8,8,0,55,55,0,0,0,0
"E00033427",240,185,89,96,0,5,0,5,49,46,0,3,0,1
"E00033428",309,148,41,107,0,109,19,90,48,42,0,2,4,4
"E00033432",321,142,62,80,0,134,65,69,38,36,0,0,2,7
"E00033435",289,199,71,128,2,71,10,61,14,13,0,1,0,3
"E00033436",275,123,49,74,0,129,43,86,20,20,0,0,0,3
"E00033437",266,191,63,128,3,58,32,26,13,13,0,0,0,1
"E00033438",307,175,56,119,4,90,32,58,36,33,0,0,3,2
"E00033439",358,181,69,112,0,114,32,82,63,58,0,3,2,0
"E00033440",348,64,34,30,0,261,57,204,22,22,0,0,0,1
"E00033441",301,92,33,59,0,190,45,145,16,16,0,0,0,3
"E00033442",336,218,97,121,0,100,22,78,17,17,0,0,0,1
"E00033443",158,118,50,68,0,27,8,19,13,12,0,1,0,0
"E00033444",254,152,65,87,0,72,29,43,29,29,0,0,0,1
"E00033445",257,126,52,74,1,106,35,71,22,22,0,0,0,2
"E00033446",277,167,68,99,1,85,27,58,22,15,0,1,6,2
"E00033447",159,66,20,46,0,80,33,47,9,9,0,0,0,4
"E00033448",308,151,53,98,6,95,46,49,46,40,0,2,4,10
"E00033449",297,180,60,120,0,69,21,48,40,36,0,3,1,8
"E00033450",301,188,76,112,0,75,50,25,30,30,0,0,0,8
"E00033451",231,110,27,83,0,92,32,60,25,25,0,0,0,4
"E00033452",229,131,58,73,1,72,22,50,23,21,0,1,1,2
"E00033453",148,89,23,66,0,30,3,27,29,28,0,1,0,0
"E00033454",489,351,108,243,0,23,5,18,112,106,0,6,0,3
"E00033455",231,67,26,41,0,129,31,98,33,33,0,0,0,2
"E00033456",336,194,71,123,0,97,31,66,40,34,0,0,6,5
"E00033457",214,39,19,20,0,155,41,114,20,20,0,0,0,0
"E00033458",227,42,16,26,0,164,41,123,21,16,0,0,5,0
"E00033459",268,118,35,83,0,125,21,104,24,22,0,0,2,1
"E00033460",200,75,19,56,0,90,22,68,34,34,0,0,0,1
"E00033462",217,0,0,0,0,205,38,167,10,7,0,0,3,2
"E00033463",218,115,68,47,0,71,16,55,26,23,0,3,0,6
"E00033464",284,145,35,110,0,104,50,54,34,30,0,4,0,1
"E00033466",278,187,76,111,0,75,13,62,14,12,0,2,0,2
"E00033468",286,148,57,91,0,103,23,80,29,25,0,4,0,6
"E00033470",324,189,46,143,0,105,41,64,26,26,0,0,0,4
"E00033471",279,182,66,116,0,82,31,51,12,10,0,1,1,3
"E00033472",249,116,31,85,0,114,25,89,16,16,0,0,0,3
"E00033473",272,154,63,91,0,112,26,86,6,4,0,1,1,0
"E00033474",229,79,43,36,1,53,2,51,94,94,0,0,0,2
"E00033475",287,126,56,70,0,25,1,24,132,132,0,0,0,4
"E00033476",234,115,37,78,0,109,36,73,9,8,0,0,1,1
"E00033477",177,120,41,79,2,29,5,24,24,24,0,0,0,2
"E00033478",273,132,50,82,0,84,14,70,57,53,0,0,4,0
"E00033479",390,237,91,146,0,110,22,88,40,38,0,2,0,3
"E00033480",279,228,115,113,0,9,0,9,41,39,0,2,0,1
"E00033481",399,177,57,120,0,182,44,138,33,31,0,2,0,7
"E00033482",282,181,90,91,0,83,20,63,18,18,0,0,0,0
"E00033483",336,177,68,109,0,97,2,95,58,55,0,1,2,4
"E00033484",292,212,96,116,0,27,0,27,47,47,0,0,0,6
"E00033485",318,206,98,108,0,57,14,43,53,48,0,5,0,2
"E00033486",348,189,69,120,0,62,14,48,91,90,0,1,0,6
"E00033487",239,89,38,51,0,116,18,98,28,20,0,5,3,6
"E00033488",235,51,17,34,0,54,8,46,122,120,0,2,0,8
"E00033489",312,230,88,142,0,63,16,47,18,15,0,1,2,1
"E00033490",268,153,65,88,0,86,29,57,21,21,0,0,0,8
"E00033491",224,84,22,62,0,70,0,70,69,65,0,1,3,1
"E00033492",330,73,36,37,0,141,32,109,107,103,0,4,0,9
"E00033493",289,184,78,106,0,26,1,25,74,67,0,7,0,5
"E00033494",254,166,61,105,0,70,25,45,18,18,0,0,0,0
"E00033495",335,135,42,93,12,91,0,91,94,91,0,3,0,3
"E00033496",299,158,71,87,0,9,0,9,129,117,0,10,2,3
"E00033497",222,137,30,107,20,44,8,36,19,19,0,0,0,2
"E00033498",112,5,5,0,2,94,29,65,9,8,0,0,1,2
"E00033501",123,19,6,13,0,98,35,63,5,5,0,0,0,1
"E00033502",240,170,46,124,0,3,0,3,66,63,0,2,1,1
"E00033503",247,188,54,134,2,0,0,0,56,52,0,4,0,1
"E00033504",315,162,54,108,2,122,26,96,11,8,0,0,3,18
"E00033505",215,165,60,105,0,13,11,2,36,36,0,0,0,1
"E00033506",303,137,54,83,0,127,46,81,28,25,0,3,0,11
"E00033507",247,106,35,71,0,48,2,46,90,86,0,4,0,3
"E00033508",228,69,22,47,0,113,11,102,46,44,0,0,2,0
"E00033509",287,139,51,88,0,87,6,81,61,61,0,0,0,0
"E00033510",290,163,74,89,0,54,2,52,73,70,0,0,3,0
"E00033511",232,76,27,49,1,111,13,98,44,42,0,0,2,0
"E00033512",209,113,32,81,0,90,35,55,6,6,0,0,0,0
"E00033513",293,148,51,97,0,67,1,66,72,66,0,6,0,6
"E00033514",234,123,53,70,6,74,23,51,27,26,0,1,0,4
"E00033515",281,151,44,107,0,44,7,37,84,79,0,5,0,2
"E00033516",251,186,65,121,0,6,2,4,57,56,0,0,1,2
"E00033517",298,141,45,96,0,140,52,88,17,17,0,0,0,0
"E00033518",254,114,34,80,0,71,10,61,66,65,0,1,0,3
"E00033519",329,140,48,92,0,165,64,101,22,22,0,0,0,2
"E00033520",186,126,52,74,0,3,0,3,56,56,0,0,0,1
"E00033521",246,77,30,47,0,66,10,56,100,97,0,3,0,3
"E00033522",285,106,37,69,2,77,0,77,100,96,0,0,4,0
"E00033523",341,240,99,141,0,10,2,8,91,85,0,6,0,0
"E00033524",416,232,68,164,0,64,10,54,120,113,0,7,0,0
"E00033525",331,243,80,163,0,69,18,51,18,17,0,1,0,1
"E00033526",269,185,55,130,0,22,1,21,58,56,0,2,0,4
"E00033527",384,294,94,200,6,66,18,48,17,16,0,1,0,1
"E00033528",256,192,55,137,0,38,5,33,24,20,0,4,0,2
"E00033530",448,423,121,302,0,8,3,5,13,13,0,0,0,4
"E00033531",359,333,139,194,0,12,2,10,12,12,0,0,0,2
"E00033532",392,323,150,173,0,40,8,32,24,21,3,0,0,5
"E00033533",235,210,73,137,0,6,6,0,16,16,0,0,0,3
"E00033534",218,138,57,81,0,32,3,29,44,40,0,4,0,4
"E00033535",305,255,114,141,0,1,0,1,45,44,1,0,0,4
"E00033536",314,226,81,145,2,42,6,36,39,33,0,6,0,5
"E00033537",288,226,80,146,2,38,1,37,15,11,0,4,0,7
"E00033538",320,272,117,155,0,9,3,6,38,33,1,4,0,1
"E00033539",315,252,81,171,0,18,7,11,40,25,10,5,0,5
"E00033540",314,244,87,157,1,4,4,0,62,49,0,13,0,3
"E00033541",323,272,96,176,1,15,0,15,31,28,0,3,0,4
"E00033542",271,199,92,107,0,0,0,0,67,64,0,3,0,5
"E00033543",254,170,75,95,0,45,13,32,36,31,0,5,0,3
"E00033544",227,172,74,98,0,1,0,1,50,50,0,0,0,4
"E00033545",249,191,94,97,0,22,6,16,33,32,0,1,0,3
"E00033546",356,229,94,135,0,89,12,77,37,37,0,0,0,1
"E00033547",292,214,73,141,0,9,0,9,69,65,0,4,0,0
"E00033548",235,148,45,103,0,10,0,10,70,66,0,4,0,7
"E00033549",337,242,113,129,2,69,25,44,19,17,0,2,0,5
"E00033550",301,270,112,158,0,8,0,8,23,23,0,0,0,0
"E00033551",219,200,98,102,0,1,0,1,13,10,0,3,0,5
"E00033552",330,316,114,202,0,5,3,2,9,9,0,0,0,0
"E00033553",354,277,93,184,0,67,3,64,10,5,0,0,5,0
"E00033554",331,294,114,180,0,2,0,2,32,32,0,0,0,3
"E00033555",269,233,112,121,0,1,0,1,33,31,0,2,0,2
"E00033556",312,296,102,194,0,0,0,0,10,6,0,0,4,6
"E00033557",317,307,114,193,0,1,0,1,9,9,0,0,0,0
"E00033558",300,286,94,192,0,4,0,4,8,8,0,0,0,2
"E00033559",260,229,98,131,0,3,0,3,28,28,0,0,0,0
"E00033560",316,294,101,193,0,6,0,6,13,13,0,0,0,3
"E00033561",299,241,96,145,0,25,5,20,26,22,0,4,0,7
"E00033562",314,292,157,135,0,4,0,4,18,18,0,0,0,0
"E00033563",341,331,119,212,0,0,0,0,8,8,0,0,0,2
"E00033564",345,277,108,169,0,22,0,22,38,38,0,0,0,8
"E00033565",286,264,126,138,0,5,0,5,17,13,0,4,0,0
"E00033566",310,219,92,127,1,46,4,42,42,41,0,1,0,2
"E00033567",342,306,72,234,0,1,1,0,26,26,0,0,0,9
"E00033568",348,165,55,110,0,122,22,100,52,52,0,0,0,9
"E00033569",255,226,71,155,0,2,0,2,22,18,0,4,0,5
"E00033570",375,247,77,170,2,69,15,54,53,47,0,6,0,4
"E00033571",243,199,103,96,0,13,2,11,28,26,0,2,0,3
"E00033572",279,239,82,157,0,23,3,20,16,11,1,4,0,1
"E00033573",187,76,4,72,7,100,4,96,4,4,0,0,0,0
"E00033574",321,295,93,202,0,15,5,10,11,9,0,2,0,0
"E00033575",244,234,118,116,0,7,2,5,2,2,0,0,0,1
"E00033576",231,117,37,80,0,80,35,45,31,28,0,2,1,3
"E00033577",290,185,59,126,4,76,7,69,24,23,0,1,0,1
"E00033579",317,32,12,20,0,200,63,137,81,80,0,0,1,4
"E00033580",247,40,10,30,1,182,54,128,21,19,0,0,2,3
"E00033581",496,114,30,84,26,222,5,217,133,122,0,11,0,1
"E00033582",334,108,45,63,0,175,66,109,46,42,0,2,2,5
"E00033583",230,174,68,106,0,3,0,3,51,51,0,0,0,2
"E00033584",232,173,76,97,0,5,0,5,51,44,0,7,0,3
"E00033585",291,202,84,118,0,10,0,10,74,69,0,5,0,5
"E00033586",285,121,53,68,0,85,0,85,74,71,0,3,0,5
"E00033587",286,191,120,71,0,62,9,53,28,28,0,0,0,5
"E00033589",315,144,62,82,4,124,3,121,41,40,0,1,0,2
"E00033590",173,106,53,53,2,8,4,4,56,55,0,1,0,1
"E00033591",220,100,43,57,0,87,0,87,32,32,0,0,0,1
"E00033592",307,24,10,14,0,263,27,236,16,6,0,6,4,4
"E00033593",200,79,27,52,0,75,5,70,44,38,0,5,1,2
"E00033594",367,74,13,61,7,260,98,162,24,24,0,0,0,2
"E00033595",309,61,19,42,4,211,62,149,30,23,0,0,7,3
"E00033596",286,119,39,80,0,68,7,61,92,87,0,0,5,7
"E00033597",223,147,58,89,0,43,4,39,33,33,0,0,0,0
"E00033598",214,69,35,34,0,44,1,43,101,98,0,3,0,0
"E00033599",225,71,46,25,0,78,2,76,75,74,0,0,1,1
"E00033600",240,79,22,57,0,139,26,113,22,21,0,1,0,0
"E00033601",264,103,72,31,0,31,1,30,123,117,0,6,0,7
"E00033602",273,187,76,111,0,1,0,1,84,81,0,3,0,1
"E00033603",302,46,8,38,0,229,26,203,21,21,0,0,0,6
"E00033604",244,93,52,41,0,44,0,44,102,98,0,2,2,5
"E00033605",286,188,89,99,0,23,3,20,72,63,0,9,0,3
"E00033606",252,124,49,75,0,5,0,5,123,122,0,1,0,0
"E00033607",214,91,45,46,0,74,7,67,49,45,0,4,0,0
"E00033608",330,177,66,111,0,91,8,83,57,55,0,2,0,5
"E00033611",302,197,77,120,0,7,0,7,98,89,2,7,0,0
"E00033613",255,134,60,74,3,43,0,43,74,67,0,6,1,1
"E00033614",338,229,95,134,0,19,0,19,90,87,0,3,0,0
"E00033616",366,221,71,150,0,108,5,103,36,36,0,0,0,1
"E00033618",362,298,124,174,0,6,1,5,55,49,0,4,2,3
"E00033620",309,222,71,151,4,47,0,47,35,35,0,0,0,1
"E00033621",270,97,19,78,0,152,66,86,15,9,0,5,1,6
"E00033623",364,49,30,19,9,280,37,243,23,23,0,0,0,3
"E00033624",280,82,36,46,0,162,52,110,33,33,0,0,0,3
"E00033625",323,289,63,226,2,3,0,3,29,27,0,2,0,0
"E00033626",438,407,27,380,2,5,0,5,24,22,0,2,0,0
"E00033627",356,256,30,226,0,18,5,13,81,65,0,16,0,1
"E00033628",312,116,44,72,0,174,64,110,20,16,0,4,0,2
"E00033629",438,295,79,216,0,94,18,76,43,43,0,0,0,6
"E00033630",237,141,56,85,0,46,7,39,50,46,0,3,1,0
"E00033631",227,90,23,67,0,101,8,93,31,28,0,0,3,5
"E00033632",334,26,12,14,3,282,75,207,23,23,0,0,0,0
"E00033633",240,207,95,112,0,5,0,5,25,18,0,7,0,3
"E00033634",362,99,29,70,1,234,68,166,22,16,0,5,1,6
"E00033635",270,230,81,149,0,6,0,6,34,34,0,0,0,0
"E00033636",417,105,28,77,0,254,79,175,51,40,0,11,0,7
"E00033637",483,265,48,217,8,98,27,71,108,99,0,9,0,4
"E00033639",302,129,45,84,0,107,15,92,55,55,0,0,0,11
"E00033640",304,114,22,92,0,137,33,104,46,40,4,2,0,7
"E00033641",303,266,137,129,0,15,2,13,12,6,0,6,0,10
"E00033642",366,346,166,180,0,3,0,3,17,15,0,2,0,0
"E00033643",229,140,43,97,2,43,2,41,44,42,0,2,0,0
"E00033644",228,31,16,15,0,182,67,115,15,15,0,0,0,0
"E00033645",251,108,41,67,0,102,12,90,41,41,0,0,0,0
"E00033646",105,31,9,22,0,61,19,42,12,12,0,0,0,1
"E00033647",257,162,38,124,0,71,23,48,23,22,0,1,0,1
"E00033648",259,93,45,48,1,127,27,100,36,27,0,4,5,2
"E00033649",311,251,13,238,0,6,0,6,54,50,0,4,0,0
"E00033650",297,108,30,78,0,155,41,114,29,25,0,0,4,5
"E00033651",141,52,21,31,0,71,27,44,18,18,0,0,0,0
"E00033652",281,98,31,67,1,154,36,118,25,25,0,0,0,3
"E00033653",278,215,28,187,0,10,6,4,50,47,0,3,0,3
"E00033654",212,57,15,42,0,128,46,82,25,23,0,2,0,2
"E00033655",433,116,46,70,0,238,48,190,73,70,3,0,0,6
"E00033656",220,103,25,78,0,100,32,68,15,14,0,0,1,2
"E00033657",210,64,24,40,0,124,52,72,19,19,0,0,0,3
"E00033658",309,100,33,67,0,156,49,107,53,53,0,0,0,0
"E00033659",392,239,72,167,0,81,23,58,62,59,0,3,0,10
"E00033660",303,130,62,68,0,141,51,90,32,32,0,0,0,0
"E00033662",374,143,49,94,0,157,53,104,70,69,0,0,1,4
"E00033663",215,88,39,49,0,106,30,76,20,9,0,11,0,1
"E00033664",233,97,41,56,0,121,26,95,13,13,0,0,0,2
"E00033665",436,241,50,191,5,117,27,90,73,69,0,3,1,0
"E00033666",236,22,2,20,2,188,16,172,14,13,0,0,1,10
"E00033667",284,139,65,74,2,108,43,65,30,30,0,0,0,5
"E00033668",278,195,61,134,0,26,1,25,57,53,0,4,0,0
"E00033669",297,85,41,44,0,200,40,160,10,10,0,0,0,2
"E00033670",289,112,39,73,0,18,16,2,158,152,0,6,0,1
"E00033672",372,38,17,21,7,244,58,186,75,69,0,6,0,8
"E00033673",250,23,1,22,0,221,44,177,4,3,0,1,0,2
"E00033677",225,60,20,40,0,154,60,94,8,8,0,0,0,3
"E00033678",299,32,13,19,0,118,12,106,147,144,0,1,2,2
"E00033684",421,81,14,67,8,280,19,261,45,33,0,0,12,7
"E00033685",321,30,13,17,1,252,74,178,31,30,0,1,0,7
"E00033686",271,64,18,46,1,191,14,177,6,5,0,0,1,9
"E00033687",389,89,23,66,0,241,12,229,58,56,0,0,2,1
"E00033688",265,42,34,8,0,201,51,150,17,14,0,0,3,5
"E00033689",330,59,31,28,25,232,30,202,9,6,0,2,1,5
"E00033690",356,70,27,43,11,196,35,161,78,73,0,5,0,1
"E00033691",216,97,39,58,0,73,7,66,40,40,0,0,0,6
"E00033692",296,148,63,85,0,0,0,0,147,138,0,9,0,1
"E00033694",235,7,0,7,0,226,18,208,1,1,0,0,0,1
"E00033695",304,106,37,69,0,141,62,79,52,50,0,0,2,5
"E00033696",426,182,76,106,0,172,59,113,65,58,0,1,6,7
"E00033697",341,202,72,130,0,93,26,67,39,35,0,4,0,7
"E00033698",410,229,86,143,0,107,25,82,70,70,0,0,0,4
"E00033699",323,224,83,141,0,6,0,6,84,82,0,2,0,9
"E00033700",209,163,48,115,0,8,0,8,37,33,0,4,0,1
"E00033701",363,320,67,253,0,8,0,8,35,33,0,2,0,0
"E00033702",161,59,20,39,0,84,13,71,15,14,0,0,1,3
"E00033703",276,78,41,37,0,166,24,142,23,20,0,0,3,9
"E00033704",393,370,45,325,0,5,0,5,18,16,0,2,0,0
"E00033705",366,342,60,282,0,2,0,2,22,16,3,3,0,0
"E00033706",264,117,58,59,0,99,37,62,48,45,0,2,1,0
"E00033707",241,160,48,112,0,0,0,0,81,72,0,9,0,0
"E00033708",194,87,46,41,0,89,26,63,17,15,0,0,2,1
"E00033709",202,119,43,76,0,57,9,48,26,26,0,0,0,0
"E00033710",307,184,65,119,0,36,6,30,86,85,0,1,0,1
"E00033711",124,40,24,16,0,66,31,35,16,16,0,0,0,2
"E00033712",360,286,110,176,0,46,11,35,24,22,0,2,0,4
"E00033713",271,216,62,154,0,0,0,0,54,53,0,1,0,1
"E00033715",362,227,47,180,0,33,3,30,101,101,0,0,0,1
"E00033716",204,84,32,52,0,103,15,88,14,11,0,2,1,3
"E00033717",239,160,12,148,0,37,6,31,39,36,0,1,2,3
"E00033718",334,278,27,251,20,21,5,16,15,13,0,2,0,0
"E00033719",347,284,33,251,0,35,4,31,28,28,0,0,0,0
"E00033720",324,287,118,169,2,3,0,3,31,23,4,4,0,1
"E00033721",312,290,45,245,0,3,0,3,14,10,4,0,0,5
"E00033722",224,193,86,107,0,3,2,1,28,27,1,0,0,0
"E00033723",372,327,108,219,0,9,0,9,35,30,2,3,0,1
"E00033724",321,154,48,106,0,125,19,106,37,34,3,0,0,5
"E00033725",329,128,56,72,0,128,35,93,71,16,45,1,9,2
"E00033726",230,172,72,100,2,0,0,0,54,53,0,1,0,2
"E00033727",305,135,52,83,0,114,23,91,54,50,0,4,0,2
"E00033728",442,418,72,346,0,0,0,0,22,20,0,2,0,2
"E00033729",231,180,53,127,0,2,0,2,49,47,0,2,0,0
"E00033730",301,216,70,146,1,38,12,26,46,46,0,0,0,0
"E00033731",164,116,42,74,0,1,0,1,47,33,0,14,0,0
"E00033732",276,181,64,117,0,69,23,46,26,26,0,0,0,0
"E00033733",237,165,55,110,0,17,4,13,54,52,0,0,2,1
"E00033734",230,124,29,95,0,34,3,31,72,68,0,3,1,0
"E00033735",111,7,5,2,0,98,3,95,5,5,0,0,0,1
"E00033736",249,130,53,77,0,41,4,37,78,77,0,1,0,0
"E00033737",386,289,92,197,0,20,0,20,66,64,0,2,0,11
"E00033738",188,47,25,22,0,92,5,87,45,44,0,1,0,4
"E00033739",252,123,27,96,0,105,22,83,23,23,0,0,0,1
"E00033740",317,257,131,126,1,3,0,3,52,52,0,0,0,4
"E00033741",281,186,63,123,0,13,4,9,80,78,0,2,0,2
"E00033742",290,175,61,114,0,5,0,5,110,102,0,8,0,0
"E00033743",270,197,63,134,0,0,0,0,71,70,0,1,0,2
"E00033744",356,208,66,142,0,105,43,62,41,36,0,5,0,2
"E00033745",199,63,11,52,0,109,24,85,22,17,0,3,2,5
"E00033746",291,112,41,71,0,157,49,108,19,19,0,0,0,3
"E00033747",364,143,39,104,0,152,67,85,61,52,0,4,5,8
"E00033748",264,130,62,68,2,106,30,76,19,19,0,0,0,7
"E00033749",275,159,33,126,2,101,39,62,13,12,0,0,1,0
"E00033750",353,304,41,263,10,6,2,4,33,28,5,0,0,0
"E00033752",420,229,53,176,8,42,15,27,139,136,0,3,0,2
"E00033753",251,212,51,161,3,1,0,1,35,31,1,0,3,0
"E00033754",307,236,52,184,0,36,0,36,34,32,0,2,0,1
"E00033755",319,278,50,228,0,3,0,3,37,32,0,5,0,1
"E00033756",319,212,6,206,6,10,0,10,87,77,0,7,3,4
"E00033758",251,135,53,82,0,95,29,66,14,10,0,4,0,7
"E00033759",202,97,37,60,0,72,21,51,31,26,0,5,0,2
"E00033762",306,242,50,192,0,8,0,8,56,54,0,2,0,0
"E00033763",331,277,24,253,3,7,0,7,44,40,0,2,2,0
"E00033764",384,340,55,285,2,7,0,7,35,33,0,2,0,0
"E00033765",312,243,70,173,18,10,0,10,34,32,0,2,0,7
"E00033766",388,344,64,280,7,0,0,0,29,22,0,7,0,8
"E00033767",282,240,29,211,0,7,0,7,35,35,0,0,0,0
"E00033768",275,234,64,170,20,1,0,1,20,20,0,0,0,0
"E00033769",207,78,26,52,10,91,8,83,23,23,0,0,0,5
"E00033770",420,410,63,347,3,0,0,0,7,7,0,0,0,0
"E00033771",366,314,66,248,0,0,0,0,52,45,0,7,0,0
"E00033773",279,236,95,141,0,13,0,13,29,25,0,4,0,1
"E00033774",290,256,68,188,0,4,0,4,30,24,5,0,1,0
"E00033775",455,159,33,126,0,234,65,169,60,60,0,0,0,2
"E00033776",293,119,54,65,0,122,6,116,52,46,0,6,0,0
"E00033777",271,224,63,161,2,7,0,7,38,38,0,0,0,0
"E00033778",340,281,32,249,18,3,3,0,37,33,0,0,4,1
"E00033779",284,58,15,43,0,164,43,121,58,58,0,0,0,4
"E00033780",253,231,77,154,0,2,2,0,19,15,0,2,2,1
"E00033781",343,185,77,108,2,82,20,62,73,69,0,4,0,1
"E00033782",299,240,82,158,0,21,4,17,37,37,0,0,0,1
"E00033783",323,228,40,188,1,76,25,51,13,10,0,3,0,5
"E00033784",482,264,96,168,0,106,26,80,110,106,0,4,0,2
"E00033785",298,217,74,143,0,32,7,25,47,40,0,3,4,2
"E00033786",451,410,57,353,0,4,0,4,37,30,0,7,0,0
"E00033787",349,309,85,224,0,6,4,2,32,29,0,3,0,2
"E00033788",318,276,60,216,0,2,2,0,38,34,0,4,0,2
"E00033789",295,268,42,226,3,0,0,0,23,23,0,0,0,1
"E00033790",303,271,39,232,1,12,0,12,19,17,0,2,0,0
"E00033791",363,82,30,52,0,246,45,201,35,35,0,0,0,0
"E00033792",203,141,15,126,20,7,0,7,35,35,0,0,0,0
"E00033793",327,83,31,52,0,223,51,172,21,21,0,0,0,0
"E00033794",287,70,33,37,6,184,41,143,27,26,0,0,1,0
"E00033795",283,157,33,124,4,82,18,64,36,36,0,0,0,4
"E00033796",213,92,26,66,0,106,33,73,14,9,0,5,0,1
"E00033797",236,94,42,52,0,117,39,78,18,16,0,0,2,7
"E00033798",362,325,112,213,0,9,0,9,25,24,0,1,0,3
"E00033799",300,160,55,105,0,128,49,79,8,7,0,1,0,4
"E00033800",201,163,16,147,0,10,2,8,28,23,5,0,0,0
"E00033801",267,103,42,61,0,137,47,90,15,15,0,0,0,12
"E00033802",189,74,33,41,4,94,47,47,16,16,0,0,0,1
"E00033803",267,124,33,91,0,113,36,77,25,25,0,0,0,5
"E00033804",291,110,43,67,0,131,32,99,45,45,0,0,0,5
"E00033805",177,34,19,15,0,126,46,80,17,17,0,0,0,0
"E00033806",190,26,11,15,13,72,0,72,75,70,4,0,1,4
"E00033807",441,39,8,31,19,315,20,295,65,64,0,0,1,3
"E00033808",246,46,29,17,0,153,91,62,37,37,0,0,0,10
"E00033810",264,30,24,6,0,201,17,184,26,26,0,0,0,7
"E00033811",581,110,63,47,0,391,117,274,67,63,0,0,4,13
"E00033812",391,37,7,30,0,308,62,246,37,33,0,0,4,9
"E00033813",534,116,61,55,0,322,85,237,73,65,0,5,3,23
"E00033814",353,12,3,9,0,312,32,280,24,24,0,0,0,5
"E00033815",311,91,43,48,2,175,28,147,38,35,0,0,3,5
"E00033816",313,118,68,50,6,132,14,118,52,48,0,2,2,5
"E00033818",321,34,10,24,3,255,97,158,16,15,0,0,1,13
"E00033819",235,11,4,7,3,137,9,128,83,81,0,0,2,1
"E00033820",251,15,5,10,0,202,15,187,27,24,0,3,0,7
"E00033821",161,20,14,6,1,73,1,72,63,56,0,6,1,4
"E00033822",429,47,24,23,2,316,38,278,56,53,0,0,3,8
"E00033823",167,70,45,25,0,41,2,39,56,39,0,17,0,0
"E00033824",483,76,42,34,0,334,8,326,53,44,0,9,0,20
"E00033825",305,58,36,22,0,174,8,166,66,59,0,1,6,7
"E00033826",275,65,29,36,2,26,0,26,182,168,0,13,1,0
"E00033827",224,54,35,19,7,65,13,52,98,86,3,8,1,0
"E00033828",345,62,20,42,0,166,8,158,105,94,0,6,5,12
"E00033829",207,14,9,5,8,93,2,91,89,87,0,0,2,3
"E00033832",209,67,42,25,0,31,0,31,107,103,0,2,2,4
"E00033833",298,32,7,25,3,104,6,98,147,135,2,10,0,12
"E00033836",118,18,5,13,0,64,4,60,36,36,0,0,0,0
"E00033837",287,108,51,57,4,151,52,99,16,13,0,1,2,8
"E00033838",259,52,28,24,0,176,26,150,19,19,0,0,0,12
"E00033839",519,185,78,107,27,246,67,179,49,48,0,0,1,12
"E00033840",334,37,7,30,7,164,12,152,126,126,0,0,0,0
"E00033841",286,62,23,39,0,212,15,197,10,8,0,0,2,2
"E00033842",368,25,15,10,2,209,51,158,126,118,0,2,6,6
"E00033843",371,36,13,23,11,268,80,188,38,17,0,2,19,18
"E00033844",348,37,15,22,2,267,74,193,33,33,0,0,0,9
"E00033845",213,17,8,9,1,61,6,55,131,131,0,0,0,3
"E00033846",411,18,3,15,2,252,22,230,133,133,0,0,0,6
"E00033847",246,29,18,11,2,167,31,136,41,36,0,0,5,7
"E00033848",383,360,121,239,2,6,0,6,14,10,4,0,0,1
"E00033849",347,299,116,183,0,0,0,0,46,44,0,2,0,2
"E00033850",378,354,173,181,2,0,0,0,22,19,0,1,2,0
"E00033851",291,205,90,115,0,8,1,7,74,65,0,8,1,4
"E00033852",260,171,70,101,0,5,0,5,80,80,0,0,0,4
"E00033853",276,202,78,124,0,10,0,10,61,58,3,0,0,3
"E00033854",373,335,155,180,0,12,1,11,26,26,0,0,0,0
"E00033855",175,115,72,43,0,30,7,23,24,19,0,5,0,6
"E00033856",246,24,5,19,8,180,23,157,26,24,0,0,2,8
"E00033857",248,213,97,116,0,10,2,8,25,20,0,5,0,0
"E00033859",246,190,96,94,0,0,0,0,56,56,0,0,0,0
"E00033861",296,179,64,115,10,42,6,36,64,56,0,8,0,1
"E00033862",294,222,96,126,0,4,0,4,60,60,0,0,0,8
"E00033863",310,305,90,215,0,1,1,0,4,1,0,3,0,0
"E00033864",279,244,100,144,0,14,2,12,21,14,0,7,0,0
"E00033865",368,338,112,226,0,0,0,0,30,30,0,0,0,0
"E00033866",310,277,130,147,0,24,2,22,9,9,0,0,0,0
"E00033867",299,281,109,172,0,11,0,11,3,3,0,0,0,4
"E00033868",333,320,105,215,0,0,0,0,11,11,0,0,0,2
"E00033869",315,300,149,151,0,0,0,0,15,11,0,4,0,0
"E00033870",257,29,18,11,4,203,75,128,16,13,0,0,3,5
"E00033871",298,264,94,170,0,5,0,5,29,29,0,0,0,0
"E00033872",330,312,118,194,0,3,0,3,13,13,0,0,0,2
"E00033873",316,201,74,127,0,62,6,56,42,35,4,0,3,11
"E00033874",329,304,155,149,0,0,0,0,23,23,0,0,0,2
"E00033875",318,314,117,197,0,3,0,3,1,1,0,0,0,0
"E00033876",289,268,119,149,0,3,3,0,17,17,0,0,0,1
"E00033877",351,334,137,197,0,10,3,7,7,7,0,0,0,0
"E00033878",287,268,126,142,0,3,0,3,16,16,0,0,0,0
"E00033879",300,281,111,170,0,11,0,11,8,8,0,0,0,0
"E00033880",457,344,155,189,0,9,2,7,96,94,0,2,0,8
"E00033881",317,288,131,157,0,5,0,5,24,22,0,2,0,0
"E00033882",280,257,98,159,0,4,0,4,12,12,0,0,0,7
"E00033883",287,252,111,141,0,3,0,3,32,29,0,1,2,0
"E00033884",333,313,140,173,2,0,0,0,14,14,0,0,0,4
"E00033885",466,367,144,223,0,3,2,1,96,88,0,8,0,0
"E00033886",276,262,104,158,1,0,0,0,10,7,0,3,0,3
"E00033887",388,322,108,214,3,5,5,0,57,49,6,2,0,1
"E00033888",335,323,134,189,0,2,0,2,4,4,0,0,0,6
"E00033889",306,290,135,155,0,2,0,2,14,14,0,0,0,0
"E00033890",198,58,17,41,1,80,13,67,53,47,0,3,3,6
"E00033891",252,217,93,124,0,5,3,2,29,29,0,0,0,1
"E00033892",114,53,21,32,0,56,6,50,5,5,0,0,0,0
"E00033893",265,223,106,117,0,1,0,1,37,33,0,4,0,4
"E00033894",311,291,85,206,0,1,0,1,17,16,0,0,1,2
"E00033895",207,108,44,64,0,0,0,0,99,89,0,10,0,0
"E00033896",291,173,80,93,2,14,0,14,100,92,0,7,1,2
"E00033897",274,250,115,135,0,5,3,2,19,16,0,3,0,0
"E00033898",359,166,74,92,2,78,5,73,109,102,0,7,0,4
"E00033899",259,88,64,24,0,50,9,41,113,111,0,0,2,8
"E00033900",265,92,38,54,0,107,14,93,66,60,0,6,0,0
"E00033901",283,63,29,34,0,115,5,110,99,99,0,0,0,6
"E00033902",328,82,33,49,7,118,8,110,119,119,0,0,0,2
"E00033903",210,54,25,29,0,57,0,57,92,90,0,2,0,7
"E00033904",296,117,79,38,0,169,38,131,8,8,0,0,0,2
"E00033905",181,5,5,0,0,172,2,170,3,3,0,0,0,1
"E00033906",202,37,6,31,0,75,3,72,88,86,0,2,0,2
"E00033907",286,94,36,58,0,74,5,69,111,108,0,3,0,7
"E00033908",282,66,29,37,0,86,4,82,119,116,0,3,0,11
"E00033909",280,156,77,79,6,17,0,17,97,91,0,5,1,4
"E00033910",386,148,69,79,2,39,0,39,177,172,0,5,0,20
"E00033911",368,101,51,50,0,90,0,90,177,165,0,12,0,0
"E00033913",233,74,23,51,28,51,6,45,78,76,0,2,0,2
"E00033914",330,96,41,55,3,92,1,91,126,121,0,3,2,13
"E00033915",196,73,34,39,0,51,4,47,68,68,0,0,0,4
"E00033917",289,162,44,118,0,51,4,47,75,70,0,5,0,1
"E00033918",247,92,47,45,0,87,24,63,61,56,1,1,3,7
"E00033919",250,85,36,49,0,153,25,128,10,9,0,0,1,2
"E00033920",245,57,25,32,0,153,9,144,31,30,0,1,0,4
"E00033921",313,40,13,27,2,35,4,31,226,222,0,4,0,10
"E00033922",341,246,101,145,0,10,4,6,85,83,0,2,0,0
"E00033923",232,61,27,34,0,68,9,59,94,92,0,2,0,9
"E00033924",381,77,34,43,3,78,0,78,222,219,0,3,0,1
"E00033925",233,29,11,18,0,105,10,95,85,84,0,0,1,14
"E00033926",300,41,18,23,0,87,4,83,170,168,0,2,0,2
"E00033927",378,165,83,82,0,49,2,47,159,142,0,12,5,5
"E00033928",262,67,15,52,0,160,28,132,31,29,0,0,2,4
"E00033930",260,76,40,36,0,61,0,61,119,116,0,3,0,4
"E00033931",278,120,27,93,4,34,5,29,102,102,0,0,0,18
"E00033932",316,166,76,90,0,39,4,35,109,100,0,6,3,2
"E00033933",256,88,33,55,0,36,0,36,122,116,0,6,0,10
"E00033934",288,45,12,33,0,112,7,105,116,112,0,1,3,15
"E00033935",330,44,13,31,2,117,3,114,146,139,0,7,0,21
"E00033936",273,88,43,45,0,24,2,22,159,157,0,0,2,2
"E00033937",196,44,31,13,0,64,0,64,82,82,0,0,0,6
"E00033938",282,115,57,58,0,53,7,46,110,104,0,6,0,4
"E00033939",273,64,31,33,0,128,5,123,81,77,0,0,4,0
"E00033940",301,85,29,56,5,115,10,105,86,81,0,2,3,10
"E00033941",318,107,53,54,3,99,16,83,103,98,0,0,5,6
"E00033942",354,168,42,126,0,90,8,82,94,92,0,2,0,2
"E00033943",292,158,81,77,0,12,0,12,122,116,0,6,0,0
"E00033944",248,56,21,35,1,66,2,64,117,106,0,1,10,8
"E00033945",183,93,31,62,0,36,4,32,54,46,0,7,1,0
"E00033946",410,157,27,130,4,162,12,150,85,70,0,11,4,2
"E00033947",269,94,30,64,0,114,0,114,60,57,1,2,0,1
"E00033948",333,107,51,56,0,158,9,149,64,64,0,0,0,4
"E00033949",280,66,28,38,1,155,5,150,57,57,0,0,0,1
"E00033950",413,205,94,111,5,134,16,118,66,48,6,8,4,3
"E00033951",249,161,89,72,0,62,25,37,16,14,0,2,0,10
"E00033952",354,325,119,206,0,8,2,6,18,17,0,1,0,3
"E00033953",379,131,58,73,2,144,16,128,95,95,0,0,0,7
"E00033954",214,39,19,20,0,172,54,118,3,3,0,0,0,0
"E00033955",344,111,52,59,1,166,5,161,63,63,0,0,0,3
"E00033956",102,21,11,10,0,77,14,63,0,0,0,0,0,4
"E00033957",314,169,52,117,1,32,6,26,108,107,1,0,0,4
"E00033958",320,71,29,42,0,184,12,172,65,65,0,0,0,0
"E00033959",264,129,50,79,0,57,0,57,78,76,0,2,0,0
"E00033960",331,172,50,122,0,75,0,75,83,79,0,4,0,1
"E00033961",277,112,70,42,0,96,6,90,67,62,0,5,0,2
"E00033962",292,141,43,98,0,55,8,47,93,93,0,0,0,3
"E00033963",357,56,22,34,0,252,37,215,45,40,0,5,0,4
"E00033964",286,46,23,23,0,187,73,114,41,39,0,2,0,12
"E00033965",253,72,40,32,0,127,12,115,52,52,0,0,0,2
"E00033966",257,145,55,90,0,20,0,20,87,79,0,8,0,5
"E00033967",278,88,41,47,0,114,31,83,72,66,0,2,4,4
"E00033968",145,24,9,15,0,84,20,64,37,35,0,2,0,0
"E00033969",246,181,58,123,8,20,2,18,37,35,0,2,0,0
"E00033970",285,111,44,67,0,152,56,96,22,13,0,9,0,0
"E00033971",183,39,20,19,17,117,10,107,10,10,0,0,0,0
"E00033972",251,99,41,58,4,82,24,58,65,53,0,8,4,1
"E00033973",182,65,29,36,1,74,25,49,40,38,0,0,2,2
"E00033974",261,64,23,41,1,162,30,132,30,30,0,0,0,4
"E00033975",348,107,40,67,1,169,52,117,67,63,0,2,2,4
"E00033976",211,147,49,98,0,32,8,24,31,27,0,4,0,1
"E00033977",156,56,27,29,0,78,22,56,21,20,1,0,0,1
"E00033978",165,56,22,34,0,83,29,54,24,21,2,1,0,2
"E00033979",121,13,6,7,0,105,14,91,3,3,0,0,0,0
"E00033980",242,66,22,44,0,148,62,86,21,17,0,0,4,7
"E00033981",148,13,3,10,0,112,18,94,15,13,0,0,2,8
"E00033982",110,39,17,22,0,61,13,48,2,2,0,0,0,8
"E00033983",233,101,17,84,2,32,0,32,90,88,0,2,0,8
"E00033984",235,188,78,110,0,0,0,0,47,44,0,3,0,0
"E00033985",206,87,43,44,0,38,0,38,80,78,0,2,0,1
"E00033986",266,218,92,126,0,14,0,14,33,28,0,0,5,1
"E00033987",260,155,46,109,0,14,0,14,85,79,0,6,0,6
"E00033988",246,131,38,93,0,15,0,15,96,91,0,3,2,4
"E00033989",229,133,45,88,0,27,3,24,67,64,0,1,2,2
"E00033990",314,215,69,146,0,6,2,4,93,90,0,3,0,0
"E00033991",289,189,67,122,0,14,0,14,85,78,0,7,0,1
"E00033992",264,98,41,57,0,151,33,118,12,8,0,0,4,3
"E00033993",418,153,24,129,44,202,28,174,14,13,0,1,0,5
"E00033994",376,235,77,158,0,17,0,17,124,124,0,0,0,0
"E00033995",252,206,80,126,0,3,0,3,43,43,0,0,0,0
"E00033996",297,226,99,127,2,18,6,12,51,48,0,3,0,0
"E00033997",341,156,41,115,1,141,3,138,42,28,4,3,7,1
"E00033998",293,108,39,69,1,154,19,135,29,29,0,0,0,1
"E00033999",290,24,12,12,0,259,29,230,6,6,0,0,0,1
"E00034000",295,102,50,52,0,181,28,153,11,10,0,1,0,1
"E00034001",301,197,30,167,22,64,11,53,12,12,0,0,0,6
"E00034002",239,100,57,43,0,121,23,98,15,13,0,0,2,3
"E00034003",229,6,0,6,0,211,6,205,8,1,0,4,3,4
"E00034004",204,83,41,42,0,111,33,78,8,5,0,1,2,2
"E00034005",309,205,61,144,18,66,9,57,16,11,0,5,0,4
"E00034006",265,164,54,110,10,76,13,63,9,6,0,3,0,6
"E00034007",214,97,42,55,0,92,19,73,25,25,0,0,0,0
"E00034008",280,144,44,100,0,119,14,105,17,14,0,3,0,0
"E00034009",242,101,55,46,3,132,49,83,4,4,0,0,0,2
"E00034010",205,106,40,66,0,91,9,82,6,6,0,0,0,2
"E00034011",363,272,57,215,0,54,4,50,36,29,0,6,1,1
"E00034012",281,79,20,59,0,192,56,136,9,9,0,0,0,1
"E00034013",270,138,57,81,0,104,23,81,28,22,0,6,0,0
"E00034014",239,136,59,77,0,84,16,68,16,16,0,0,0,3
"E00034015",267,101,45,56,0,151,48,103,13,13,0,0,0,2
"E00034016",265,96,43,53,0,165,27,138,4,4,0,0,0,0
"E00034017",326,249,86,163,2,21,1,20,51,46,0,1,4,3
"E00034019",287,177,81,96,0,24,16,8,85,75,0,5,5,1
"E00034020",323,223,79,144,0,2,0,2,98,81,0,17,0,0
"E00034021",304,216,52,164,4,53,19,34,30,30,0,0,0,1
"E00034022",355,252,90,162,0,15,0,15,88,87,0,1,0,0
"E00034023",229,92,39,53,2,69,9,60,61,45,9,5,2,5
"E00034024",299,121,18,103,0,69,21,48,101,92,0,7,2,8
"E00034025",360,84,34,50,0,238,35,203,35,34,0,0,1,3
"E00034026",271,136,68,68,0,71,0,71,63,59,0,4,0,1
"E00034027",230,121,29,92,0,36,3,33,70,65,0,5,0,3
"E00034028",305,77,28,49,0,102,9,93,122,113,1,8,0,4
"E00034029",380,194,55,139,3,102,16,86,81,76,0,5,0,0
"E00034030",268,178,72,106,0,33,6,27,55,54,0,1,0,2
"E00034031",236,170,77,93,0,10,0,10,47,46,0,1,0,9
"E00034032",324,307,126,181,0,4,0,4,13,13,0,0,0,0
"E00034033",255,194,69,125,0,2,0,2,53,50,0,3,0,6
"E00034034",307,211,62,149,0,24,0,24,70,66,0,4,0,2
"E00034035",314,207,77,130,0,17,1,16,84,80,2,2,0,6
"E00034036",314,287,100,187,0,2,2,0,25,22,0,3,0,0
"E00034037",333,282,104,178,3,9,0,9,39,37,0,2,0,0
"E00034038",346,273,96,177,0,11,3,8,55,52,0,3,0,7
"E00034039",301,194,75,119,1,80,5,75,23,23,0,0,0,3
"E00034040",268,201,73,128,0,13,0,13,54,54,0,0,0,0
"E00034041",316,276,117,159,0,9,0,9,29,29,0,0,0,2
"E00034042",307,216,98,118,1,20,4,16,69,63,0,6,0,1
"E00034043",336,189,70,119,0,67,1,66,67,63,0,3,1,13
"E00034044",350,213,83,130,0,24,8,16,109,101,0,4,4,4
"E00034045",330,171,51,120,0,62,15,47,93,89,0,4,0,4
"E00034046",276,114,50,64,0,73,5,68,89,81,0,5,3,0
"E00034047",283,183,45,138,0,13,1,12,76,58,0,17,1,11
"E00034048",266,207,82,125,0,0,0,0,59,57,0,2,0,0
"E00034049",297,210,85,125,4,5,0,5,75,75,0,0,0,3
"E00034050",321,200,58,142,0,7,5,2,114,107,0,7,0,0
"E00034051",199,115,29,86,0,17,1,16,67,62,0,5,0,0
"E00034052",266,169,48,121,0,6,0,6,90,84,0,6,0,1
"E00034053",362,189,66,123,2,57,0,57,108,101,0,7,0,6
"E00034054",328,237,103,134,0,4,0,4,85,81,0,4,0,2
"E00034055",327,158,55,103,0,25,9,16,138,134,1,3,0,6
"E00034056",237,99,43,56,0,42,2,40,91,91,0,0,0,5
"E00034057",237,86,29,57,0,81,3,78,70,70,0,0,0,0
"E00034058",277,62,19,43,0,185,39,146,20,19,0,1,0,10
"E00034059",430,193,81,112,0,112,10,102,125,116,0,7,2,0
"E00034061",354,243,79,164,0,4,0,4,107,99,0,8,0,0
"E00034062",474,100,49,51,1,91,6,85,277,262,0,9,6,5
"E00034063",468,96,30,66,15,25,1,24,319,302,0,14,3,13
"E00034064",483,72,30,42,5,38,2,36,364,354,0,5,5,4
"E00034065",292,238,106,132,0,3,0,3,49,45,0,4,0,2
"E00034066",270,52,27,25,0,133,13,120,82,78,0,4,0,3
"E00034067",307,191,68,123,0,11,5,6,105,103,0,2,0,0
"E00034068",299,102,34,68,9,60,0,60,116,113,0,3,0,12
"E00034069",435,131,72,59,1,55,1,54,239,230,0,9,0,9
"E00034070",359,48,25,23,0,78,8,70,229,227,0,0,2,4
"E00034071",385,153,72,81,0,82,3,79,146,143,0,3,0,4
"E00034072",300,48,15,33,2,157,20,137,88,84,0,2,2,5
"E00034073",277,88,41,47,0,14,2,12,168,163,0,5,0,7
"E00034074",332,109,35,74,2,73,4,69,142,134,0,6,2,6
"E00034075",261,99,52,47,0,78,10,68,79,74,0,2,3,5
"E00034076",301,86,44,42,0,41,10,31,170,169,0,0,1,4
"E00034077",247,73,42,31,0,111,6,105,63,62,0,0,1,0
"E00034078",266,54,18,36,2,129,22,107,78,74,0,0,4,3
"E00034079",291,80,38,42,0,60,2,58,147,144,0,3,0,4
"E00034080",236,81,32,49,0,42,2,40,113,108,0,5,0,0
"E00034081",378,74,16,58,2,121,19,102,181,177,0,0,4,0
"E00034082",241,70,37,33,0,85,10,75,86,86,0,0,0,0
"E00034083",273,85,38,47,0,40,1,39,148,148,0,0,0,0
"E00034084",282,44,8,36,0,41,0,41,197,189,0,5,3,0
"E00034085",268,83,31,52,0,62,0,62,121,112,0,9,0,2
"E00034086",178,50,19,31,0,46,0,46,82,82,0,0,0,0
"E00034087",251,77,38,39,4,12,4,8,158,148,2,6,2,0
"E00034088",301,69,22,47,2,92,10,82,136,136,0,0,0,2
"E00034089",308,125,45,80,0,16,0,16,163,157,0,6,0,4
"E00034090",330,110,33,77,1,17,0,17,200,170,16,14,0,2
"E00034091",241,76,23,53,2,22,6,16,141,133,0,8,0,0
"E00034092",226,74,27,47,4,18,0,18,119,119,0,0,0,11
"E00034093",385,115,59,56,0,79,12,67,190,187,0,2,1,1
"E00034094",417,123,70,53,4,30,4,26,260,246,0,13,1,0
"E00034095",250,86,36,50,0,14,2,12,149,144,0,5,0,1
"E00034096",336,103,57,46,9,18,4,14,203,195,0,8,0,3
"E00034097",342,111,54,57,5,24,0,24,197,194,0,3,0,5
"E00034098",334,151,68,83,0,24,0,24,152,128,0,24,0,7
"E00034099",316,108,60,48,0,24,0,24,181,181,0,0,0,3
"E00034100",327,163,61,102,0,37,4,33,125,105,2,18,0,2
"E00034101",278,157,55,102,0,5,0,5,107,90,0,17,0,9
"E00034102",263,102,40,62,0,56,1,55,100,93,0,4,3,5
"E00034104",322,204,76,128,3,29,6,23,86,81,0,5,0,0
"E00034105",363,64,15,49,2,165,6,159,130,121,0,1,8,2
"E00034106",222,158,48,110,0,19,0,19,42,41,0,1,0,3
"E00034107",322,158,76,82,0,32,2,30,132,117,0,15,0,0
"E00034108",195,37,12,25,8,83,8,75,62,60,0,2,0,5
"E00034109",195,33,16,17,0,99,2,97,58,56,0,2,0,5
"E00034110",309,183,64,119,0,2,0,2,124,120,0,4,0,0
"E00034111",267,82,26,56,0,172,61,111,9,6,0,0,3,4
"E00034113",305,139,42,97,3,124,24,100,37,35,0,0,2,2
"E00034114",316,147,56,91,0,138,36,102,27,27,0,0,0,4
"E00034115",293,160,49,111,0,115,13,102,17,13,0,4,0,1
"E00034116",337,82,34,48,0,221,48,173,29,29,0,0,0,5
"E00034117",272,88,46,42,0,170,35,135,9,9,0,0,0,5
"E00034118",222,93,37,56,0,99,29,70,30,25,0,5,0,0
"E00034119",293,133,46,87,0,139,36,103,15,11,0,2,2,6
"E00034120",279,149,52,97,0,114,19,95,13,7,0,0,6,3
"E00034121",287,121,47,74,0,125,40,85,33,33,0,0,0,8
"E00034122",327,58,35,23,0,251,56,195,16,16,0,0,0,2
"E00034123",362,19,7,12,0,334,101,233,9,9,0,0,0,0
"E00034124",337,41,36,5,0,277,60,217,16,14,0,0,2,3
"E00034125",294,92,31,61,2,170,44,126,26,23,0,0,3,4
"E00034126",371,278,96,182,0,19,1,18,70,70,0,0,0,4
"E00034127",350,170,36,134,0,145,56,89,31,31,0,0,0,4
"E00034130",288,137,70,67,0,118,27,91,32,32,0,0,0,1
"E00034131",379,208,72,136,0,118,36,82,50,46,0,4,0,3
"E00034132",189,83,37,46,0,91,19,72,15,15,0,0,0,0
"E00034133",248,141,46,95,0,74,24,50,32,32,0,0,0,1
"E00034134",311,130,36,94,1,160,50,110,18,12,0,5,1,2
"E00034135",221,171,55,116,0,4,0,4,46,46,0,0,0,0
"E00034136",335,154,43,111,0,142,42,100,36,36,0,0,0,3
"E00034137",269,112,32,80,0,123,37,86,34,30,0,0,4,0
"E00034138",306,41,23,18,0,211,47,164,49,49,0,0,0,5
"E00034139",299,100,39,61,0,194,57,137,5,2,0,3,0,0
"E00034140",234,148,56,92,0,73,30,43,12,12,0,0,0,1
"E00034141",228,49,11,38,0,161,31,130,15,15,0,0,0,3
"E00034142",388,218,86,132,0,149,31,118,18,17,0,0,1,3
"E00034143",309,196,67,129,0,95,11,84,16,12,0,2,2,2
"E00034144",361,173,41,132,0,138,46,92,47,43,0,4,0,3
"E00034145",250,92,45,47,1,89,35,54,65,61,0,1,3,3
"E00034146",310,39,22,17,0,246,53,193,23,19,0,0,4,2
"E00034147",247,76,32,44,0,148,69,79,23,21,0,2,0,0
"E00034148",409,13,3,10,7,368,85,283,10,10,0,0,0,11
"E00034149",280,91,31,60,0,173,52,121,15,15,0,0,0,1
"E00034150",208,104,45,59,0,91,15,76,13,12,0,1,0,0
"E00034151",305,8,7,1,2,281,71,210,5,5,0,0,0,9
"E00034152",298,195,46,149,0,81,26,55,14,14,0,0,0,8
"E00034153",312,21,9,12,0,278,92,186,12,12,0,0,0,1
"E00034154",341,167,63,104,0,143,29,114,27,27,0,0,0,4
"E00034155",398,48,9,39,0,310,30,280,35,27,1,6,1,5
"E00034156",240,9,0,9,0,215,21,194,15,7,0,0,8,1
"E00034157",293,134,48,86,0,130,40,90,27,25,0,2,0,2
"E00034158",335,198,60,138,0,122,44,78,14,14,0,0,0,1
"E00034159",289,198,55,143,3,55,13,42,30,29,0,0,1,3
"E00034160",267,171,57,114,0,81,22,59,15,10,0,5,0,0
"E00034161",264,121,33,88,0,77,3,74,62,62,0,0,0,4
"E00034162",354,187,73,114,0,64,9,55,101,91,0,10,0,2
"E00034163",253,103,46,57,0,114,23,91,36,36,0,0,0,0
"E00034164",338,152,70,82,2,93,11,82,87,80,0,3,4,4
"E00034165",263,29,13,16,2,211,28,183,21,10,0,11,0,0
"E00034167",394,119,73,46,0,204,18,186,60,60,0,0,0,11
"E00034168",331,171,49,122,0,139,33,106,16,16,0,0,0,5
"E00034169",277,107,45,62,0,31,6,25,139,139,0,0,0,0
"E00034170",304,213,53,160,0,70,11,59,18,18,0,0,0,3
"E00034171",244,144,58,86,3,58,10,48,39,39,0,0,0,0
"E00034172",290,169,51,118,0,60,3,57,59,55,0,2,2,2
"E00034173",243,149,26,123,5,26,14,12,60,55,0,5,0,3
"E00034174",251,169,53,116,0,41,1,40,37,37,0,0,0,4
"E00034175",248,78,34,44,0,129,13,116,41,36,1,2,2,0
"E00034176",162,122,29,93,0,12,4,8,28,28,0,0,0,0
"E00034177",267,165,55,110,28,12,0,12,60,56,0,4,0,2
"E00034178",295,175,54,121,1,40,0,40,76,67,0,6,3,3
"E00034180",360,217,84,133,0,54,3,51,88,88,0,0,0,1
"E00034182",133,23,8,15,0,102,17,85,8,6,0,2,0,0
"E00034184",252,82,31,51,0,121,8,113,47,44,0,3,0,2
"E00034185",238,134,56,78,0,82,11,71,22,21,0,0,1,0
"E00034187",221,57,20,37,0,149,19,130,15,15,0,0,0,0
"E00034188",335,205,72,133,0,76,12,64,50,50,0,0,0,4
"E00034189",276,103,35,68,0,150,31,119,21,19,0,2,0,2
"E00034190",257,105,32,73,0,120,27,93,31,24,0,7,0,1
"E00034191",239,105,46,59,0,119,23,96,14,14,0,0,0,1
"E00034192",352,145,69,76,0,139,32,107,67,67,0,0,0,1
"E00034193",283,151,37,114,0,110,17,93,18,16,0,2,0,4
"E00034194",246,99,35,64,0,115,35,80,31,31,0,0,0,1
"E00034195",236,71,22,49,0,138,47,91,25,21,0,4,0,2
"E00034196",337,132,32,100,0,204,47,157,1,1,0,0,0,0
"E00034197",317,137,58,79,0,143,20,123,36,33,0,3,0,1
"E00034199",322,95,50,45,4,198,80,118,19,15,0,0,4,6
"E00034200",328,36,10,26,7,203,33,170,71,71,0,0,0,11
"E00034201",262,102,45,57,0,35,5,30,122,122,0,0,0,3
"E00034202",287,103,39,64,0,149,48,101,30,28,0,0,2,5
"E00034203",395,85,37,48,3,90,5,85,210,198,0,12,0,7
"E00034208",249,28,22,6,1,153,11,142,66,66,0,0,0,1
"E00034209",168,32,22,10,0,103,10,93,30,27,0,0,3,3
"E00034211",243,61,27,34,0,116,11,105,53,53,0,0,0,13
"E00034212",253,18,8,10,0,182,4,178,53,45,0,8,0,0
"E00034213",439,192,70,122,3,200,44,156,42,42,0,0,0,2
"E00034215",135,13,7,6,0,88,14,74,30,22,1,0,7,4
"E00034216",451,54,25,29,0,226,49,177,169,169,0,0,0,2
"E00034219",279,70,20,50,0,126,13,113,79,78,0,0,1,4
"E00034221",276,109,51,58,0,143,50,93,18,18,0,0,0,6
"E00034222",350,52,36,16,0,131,21,110,164,161,0,2,1,3
"E00034223",237,42,28,14,0,121,26,95,68,60,0,8,0,6
"E00034224",383,77,46,31,0,94,12,82,212,211,0,1,0,0
"E00034225",323,75,51,24,0,116,2,114,132,122,0,10,0,0
"E00034227",360,88,45,43,10,85,8,77,177,162,0,8,7,0
"E00034228",400,87,45,42,7,48,0,48,253,246,3,4,0,5
"E00034230",423,78,54,24,0,90,2,88,255,237,4,11,3,0
"E00034231",358,101,64,37,1,40,0,40,215,215,0,0,0,1
"E00034234",359,92,29,63,0,214,52,162,47,45,0,0,2,6
"E00034235",339,146,36,110,0,155,16,139,36,33,0,3,0,2
"E00034236",286,109,39,70,1,161,38,123,13,13,0,0,0,2
"E00034237",310,171,35,136,0,118,22,96,18,18,0,0,0,3
"E00034238",140,57,17,40,0,70,20,50,8,8,0,0,0,5
"E00034239",349,106,33,73,3,202,33,169,38,38,0,0,0,0
"E00034240",286,119,52,67,0,140,39,101,25,24,0,1,0,2
"E00034241",293,103,47,56,0,132,30,102,56,54,0,2,0,2
"E00034242",277,73,23,50,0,173,42,131,25,25,0,0,0,6
"E00034243",431,103,24,79,0,253,82,171,73,73,0,0,0,2
"E00034244",321,148,45,103,0,148,20,128,25,25,0,0,0,0
"E00034245",297,105,44,61,0,182,43,139,6,5,0,1,0,4
"E00034246",284,127,35,92,0,115,36,79,40,35,0,3,2,2
"E00034247",255,101,30,71,0,135,33,102,19,19,0,0,0,0
"E00034248",205,87,34,53,0,102,33,69,15,15,0,0,0,1
"E00034249",289,47,14,33,0,211,53,158,27,27,0,0,0,4
"E00034250",388,104,47,57,0,262,57,205,17,17,0,0,0,5
"E00034251",277,72,22,50,1,95,35,60,108,102,0,0,6,1
"E00034252",447,158,46,112,3,172,70,102,114,114,0,0,0,0
"E00034253",394,75,20,55,0,275,75,200,40,40,0,0,0,4
"E00034254",323,109,51,58,0,169,28,141,41,34,0,7,0,4
"E00034255",337,112,43,69,0,174,37,137,49,47,0,2,0,2
"E00034256",336,151,44,107,4,135,48,87,42,36,0,3,3,4
"E00034257",298,57,9,48,2,206,36,170,17,10,0,3,4,16
"E00034258",340,91,30,61,6,207,58,149,34,34,0,0,0,2
"E00034259",316,69,18,51,0,194,35,159,49,42,0,4,3,4
"E00034260",266,104,47,57,0,133,32,101,27,24,0,2,1,2
"E00034261",291,120,45,75,1,143,20,123,25,21,0,4,0,2
"E00034262",295,172,43,129,0,99,16,83,19,19,0,0,0,5
"E00034263",230,89,37,52,0,128,24,104,11,11,0,0,0,2
"E00034264",315,93,28,65,0,210,54,156,12,7,0,3,2,0
"E00034265",549,446,149,297,0,12,0,12,86,83,0,2,1,5
"E00034266",311,179,74,105,4,8,0,8,115,109,1,5,0,5
"E00034267",269,238,101,137,0,0,0,0,31,29,2,0,0,0
"E00034268",462,238,66,172,0,67,5,62,156,153,0,3,0,1
"E00034269",204,107,29,78,10,37,5,32,50,48,0,2,0,0
"E00034270",341,172,88,84,0,31,0,31,136,133,0,3,0,2
"E00034271",301,207,66,141,0,10,0,10,84,79,1,4,0,0
"E00034272",311,115,39,76,0,81,4,77,106,94,0,6,6,9
"E00034273",158,33,17,16,0,59,7,52,66,62,0,4,0,0
"E00034274",212,66,33,33,2,31,0,31,108,98,0,10,0,5
"E00034275",295,266,104,162,0,0,0,0,27,27,0,0,0,2
"E00034276",310,215,76,139,0,31,0,31,62,56,0,4,2,2
"E00034277",247,214,88,126,0,5,0,5,26,21,2,3,0,2
"E00034278",330,180,46,134,3,37,9,28,104,99,0,5,0,6
"E00034279",298,41,19,22,0,61,20,41,194,188,0,3,3,2
"E00034280",140,5,2,3,0,119,21,98,12,12,0,0,0,4
"E00034281",170,46,2,44,0,30,4,26,94,89,0,1,4,0
"E00034282",410,222,103,119,0,68,20,48,113,113,0,0,0,7
"E00034283",370,234,79,155,2,17,0,17,115,105,0,10,0,2
"E00034284",272,194,75,119,0,6,3,3,64,64,0,0,0,8
"E00034285",313,99,45,54,0,184,10,174,28,21,0,1,6,2
"E00034286",325,99,37,62,0,205,20,185,17,17,0,0,0,4
"E00034287",279,30,20,10,0,230,13,217,13,13,0,0,0,6
"E00034288",304,216,59,157,2,13,0,13,71,65,0,5,1,2
"E00034289",226,111,41,70,0,50,6,44,60,52,0,6,2,5
"E00034290",297,126,44,82,0,66,6,60,97,97,0,0,0,8
"E00034291",221,77,37,40,0,70,2,68,74,72,0,2,0,0
"E00034292",268,154,32,122,0,7,0,7,99,95,0,4,0,8
"E00034293",267,165,45,120,0,35,4,31,66,66,0,0,0,1
"E00034294",567,391,74,317,0,26,3,23,137,135,0,2,0,13
"E00034295",228,98,26,72,0,40,0,40,89,85,0,1,3,1
"E00034296",321,216,75,141,0,0,0,0,105,105,0,0,0,0
"E00034297",285,110,34,76,0,105,5,100,68,66,1,1,0,2
"E00034298",323,207,90,117,0,30,5,25,85,79,0,6,0,1
"E00034299",253,116,35,81,2,56,2,54,79,79,0,0,0,0
"E00034300",244,134,29,105,2,78,32,46,25,18,0,7,0,5
"E00034301",266,71,39,32,5,43,0,43,141,141,0,0,0,6
"E00034302",289,208,49,159,0,3,3,0,78,78,0,0,0,0
"E00034303",259,104,50,54,26,99,26,73,29,29,0,0,0,1
"E00034304",259,113,62,51,0,36,1,35,108,104,0,1,3,2
"E00034305",271,170,72,98,1,19,8,11,75,67,0,8,0,6
"E00034306",315,131,52,79,10,56,14,42,117,105,0,8,4,1
"E00034307",241,88,33,55,0,57,0,57,92,90,0,1,1,4
"E00034308",353,233,83,150,4,7,0,7,109,106,0,3,0,0
"E00034309",270,81,32,49,0,45,0,45,140,134,6,0,0,4
"E00034310",337,126,45,81,0,37,3,34,170,166,3,1,0,4
"E00034311",298,87,38,49,5,35,0,35,167,167,0,0,0,4
"E00034312",302,133,45,88,0,69,0,69,98,97,0,0,1,2
"E00034313",332,126,50,76,0,58,4,54,148,143,0,5,0,0
"E00034314",259,101,36,65,0,97,0,97,56,53,0,3,0,5
"E00034315",228,47,22,25,14,158,11,147,7,6,0,0,1,2
"E00034316",256,70,34,36,2,174,16,158,3,3,0,0,0,7
"E00034317",391,63,27,36,12,297,52,245,11,11,0,0,0,8
"E00034318",285,76,40,36,0,184,20,164,20,20,0,0,0,5
"E00034319",310,134,36,98,3,134,15,119,34,31,0,3,0,5
"E00034320",180,82,30,52,0,87,18,69,9,9,0,0,0,2
"E00034321",109,52,11,41,0,47,14,33,10,10,0,0,0,0
"E00034322",288,155,81,74,0,113,23,90,15,12,0,1,2,5
"E00034323",298,122,56,66,0,143,21,122,28,28,0,0,0,5
"E00034324",296,60,19,41,0,211,19,192,25,25,0,0,0,0
"E00034325",265,171,61,110,2,62,19,43,25,18,0,2,5,5
"E00034326",256,210,86,124,19,18,7,11,9,9,0,0,0,0
"E00034327",272,240,66,174,0,9,0,9,21,21,0,0,0,2
"E00034328",336,319,97,222,0,4,0,4,13,12,0,1,0,0
"E00034329",244,142,72,70,0,100,22,78,1,1,0,0,0,1
"E00034330",231,135,70,65,1,78,12,66,11,11,0,0,0,6
"E00034331",271,96,36,60,0,150,42,108,17,17,0,0,0,8
"E00034332",324,98,30,68,0,198,24,174,18,12,0,4,2,10
"E00034333",300,158,69,89,0,110,30,80,25,22,0,3,0,7
"E00034334",207,21,10,11,0,152,9,143,32,28,0,4,0,2
"E00034335",254,129,42,87,0,108,12,96,17,17,0,0,0,0
"E00034336",228,123,47,76,0,86,12,74,15,12,0,3,0,4
"E00034337",350,315,115,200,2,2,0,2,29,29,0,0,0,2
"E00034338",272,236,81,155,0,2,0,2,34,31,0,3,0,0
"E00034339",302,289,118,171,0,9,0,9,2,2,0,0,0,2
"E00034340",230,199,57,142,0,5,0,5,26,19,0,7,0,0
"E00034341",342,269,99,170,0,39,7,32,23,16,0,7,0,11
"E00034342",224,181,64,117,0,19,10,9,23,23,0,0,0,1
"E00034343",258,212,74,138,0,25,10,15,17,16,0,1,0,4
"E00034344",277,248,73,175,0,3,2,1,23,22,0,1,0,3
"E00034345",232,224,52,172,0,2,0,2,0,0,0,0,0,6
"E00034346",111,50,23,27,17,41,6,35,0,0,0,0,0,3
"E00034347",230,119,45,74,7,82,31,51,15,13,0,1,1,7
"E00034348",246,58,24,34,0,157,14,143,24,24,0,0,0,7
"E00034349",267,47,15,32,5,196,55,141,8,8,0,0,0,11
"E00034350",252,42,25,17,0,195,58,137,14,12,0,1,1,1
"E00034351",332,35,13,22,0,152,55,97,136,135,0,0,1,9
"E00034352",268,45,20,25,0,206,29,177,13,9,0,4,0,4
"E00034353",277,14,0,14,0,256,1,255,7,7,0,0,0,0
"E00034354",258,57,28,29,0,180,70,110,20,16,2,0,2,1
"E00034355",322,70,40,30,0,237,79,158,9,7,0,2,0,6
"E00034356",136,15,9,6,0,109,35,74,12,11,0,0,1,0
"E00034358",362,83,14,69,24,201,17,184,46,42,0,1,3,8
"E00034359",253,115,19,96,38,70,0,70,28,28,0,0,0,2
"E00034360",166,58,24,34,0,73,20,53,35,35,0,0,0,0
"E00034361",198,4,0,4,0,180,5,175,12,10,0,2,0,2
"E00034362",194,15,13,2,0,161,14,147,14,14,0,0,0,4
"E00034363",263,127,51,76,0,93,29,64,42,36,0,4,2,1
"E00034364",216,74,39,35,1,75,16,59,65,60,0,5,0,1
"E00034365",308,84,33,51,0,198,113,85,25,24,0,1,0,1
"E00034366",345,75,17,58,3,226,74,152,36,35,0,0,1,5
"E00034368",271,94,67,27,0,23,0,23,149,138,8,2,1,5
"E00034369",255,118,48,70,5,17,9,8,109,109,0,0,0,6
"E00034371",246,50,16,34,0,189,53,136,7,7,0,0,0,0
"E00034372",274,75,18,57,6,175,70,105,15,15,0,0,0,3
"E00034373",204,21,13,8,0,173,42,131,0,0,0,0,0,10
"E00034374",265,89,33,56,0,160,66,94,12,8,0,0,4,4
"E00034375",424,397,112,285,0,4,0,4,23,19,0,4,0,0
"E00034376",341,278,84,194,0,12,1,11,49,45,0,4,0,2
"E00034377",322,274,99,175,6,0,0,0,42,41,0,0,1,0
"E00034378",324,252,77,175,0,2,0,2,67,67,0,0,0,3
"E00034379",348,249,62,187,4,19,0,19,76,73,0,3,0,0
"E00034380",335,292,117,175,0,0,0,0,32,28,0,4,0,11
"E00034381",570,458,132,326,0,17,0,17,88,74,0,11,3,7
"E00034382",358,186,65,121,0,0,0,0,168,168,0,0,0,4
"E00034383",467,364,84,280,0,12,4,8,83,78,0,5,0,8
"E00034384",330,178,55,123,0,35,19,16,117,111,0,2,4,0
"E00034386",399,182,47,135,1,53,3,50,157,157,0,0,0,6
"E00034387",240,99,35,64,0,57,7,50,82,81,0,1,0,2
"E00034388",262,52,23,29,0,195,17,178,11,11,0,0,0,4
"E00034389",208,185,84,101,0,0,0,0,21,17,0,4,0,2
"E00034390",363,255,99,156,0,3,3,0,104,94,0,10,0,1
"E00034391",387,348,71,277,0,13,0,13,23,15,0,5,3,3
"E00034392",336,272,92,180,0,2,2,0,59,59,0,0,0,3
"E00034393",260,208,88,120,0,15,2,13,33,33,0,0,0,4
"E00034394",290,237,69,168,0,3,0,3,50,50,0,0,0,0
"E00034395",242,117,31,86,0,18,0,18,106,106,0,0,0,1
"E00034396",307,203,82,121,0,22,8,14,76,73,0,3,0,6
"E00034397",322,247,80,167,0,5,0,5,69,66,0,3,0,1
"E00034398",289,214,79,135,0,23,11,12,52,51,0,0,1,0
"E00034399",336,252,95,157,2,39,10,29,41,38,0,3,0,2
"E00034400",272,138,58,80,0,32,11,21,97,94,0,3,0,5
"E00034401",370,226,70,156,0,43,1,42,99,97,0,2,0,2
"E00034402",285,196,84,112,0,1,0,1,86,82,0,4,0,2
"E00034403",306,258,93,165,0,23,8,15,25,23,0,2,0,0
"E00034404",297,236,68,168,0,8,6,2,49,46,0,3,0,4
"E00034405",349,282,106,176,0,8,2,6,53,45,0,8,0,6
"E00034406",350,239,84,155,0,19,3,16,92,86,0,4,2,0
"E00034409",388,301,119,182,0,7,0,7,78,76,0,2,0,2
"E00034410",320,232,63,169,0,44,0,44,44,42,0,0,2,0
"E00034412",341,118,41,77,0,76,0,76,138,131,0,7,0,9
"E00034413",267,188,76,112,0,13,6,7,66,61,0,5,0,0
"E00034414",285,169,38,131,0,28,7,21,88,82,0,6,0,0
"E00034415",339,87,21,66,1,79,8,71,164,155,5,2,2,8
"E00034416",365,267,122,145,0,47,17,30,48,48,0,0,0,3
"E00034417",291,29,3,26,0,245,80,165,16,11,0,1,4,1
"E00034418",441,308,84,224,0,41,7,34,91,77,0,14,0,1
"E00034419",246,144,46,98,5,84,37,47,13,12,0,1,0,0
"E00034420",240,206,67,139,0,0,0,0,33,30,0,3,0,1
"E00034421",298,247,87,160,0,18,0,18,33,29,0,4,0,0
"E00034422",301,111,31,80,0,150,54,96,34,31,0,3,0,6
"E00034424",249,62,12,50,0,176,52,124,5,1,0,0,4,6
"E00034425",310,129,41,88,0,128,39,89,45,42,0,3,0,8
"E00034426",418,72,12,60,0,226,17,209,118,113,0,3,2,2
"E00034427",235,85,36,49,0,125,22,103,23,22,0,0,1,2
"E00034428",345,129,61,68,0,131,8,123,83,80,2,1,0,2
"E00034429",272,100,44,56,0,122,18,104,47,43,0,2,2,3
"E00034430",290,92,28,64,0,102,13,89,95,95,0,0,0,1
"E00034431",247,173,56,117,0,6,0,6,65,60,0,5,0,3
"E00034432",387,295,63,232,0,34,5,29,57,54,0,3,0,1
"E00034433",287,256,119,137,0,0,0,0,31,29,0,2,0,0
"E00034434",387,328,168,160,0,3,0,3,51,51,0,0,0,5
"E00034435",325,287,155,132,0,2,0,2,35,33,0,2,0,1
"E00034436",303,234,108,126,0,23,2,21,44,42,0,2,0,2
"E00034437",361,146,38,108,0,170,52,118,34,34,0,0,0,11
"E00034438",254,230,119,111,0,0,0,0,22,20,0,2,0,2
"E00034439",279,197,66,131,0,0,0,0,73,72,0,1,0,9
"E00034440",297,244,80,164,0,36,12,24,17,17,0,0,0,0
"E00034441",312,288,97,191,4,4,0,4,16,16,0,0,0,0
"E00034442",286,216,85,131,0,12,3,9,56,53,0,3,0,2
"E00034443",281,247,113,134,0,0,0,0,30,26,2,2,0,4
"E00034444",279,253,101,152,0,6,0,6,20,15,0,5,0,0
"E00034445",277,251,128,123,0,0,0,0,26,25,0,1,0,0
"E00034446",432,304,147,157,0,19,0,19,105,99,3,3,0,4
"E00034447",357,333,101,232,0,5,0,5,19,19,0,0,0,0
"E00034448",258,229,83,146,0,0,0,0,21,18,0,3,0,8
"E00034449",171,127,77,50,0,39,0,39,5,4,0,1,0,0
"E00034451",262,123,57,66,4,15,4,11,115,100,0,12,3,5
"E00034453",255,136,67,69,1,26,8,18,89,83,0,6,0,3
"E00034454",276,54,47,7,0,200,0,200,13,13,0,0,0,9
"E00034455",243,223,88,135,0,3,0,3,16,14,0,2,0,1
"E00034456",252,241,93,148,0,8,0,8,3,3,0,0,0,0
"E00034457",238,222,112,110,0,2,0,2,14,14,0,0,0,0
"E00034458",213,198,94,104,1,5,0,5,9,3,0,6,0,0
"E00034459",299,277,143,134,0,4,0,4,16,16,0,0,0,2
"E00034460",205,198,130,68,0,0,0,0,3,1,0,2,0,4
"E00034461",165,122,78,44,0,6,0,6,33,29,0,4,0,4
"E00034462",243,220,100,120,1,2,0,2,13,9,0,4,0,7
"E00034463",240,228,120,108,0,6,0,6,4,4,0,0,0,2
"E00034464",257,243,140,103,0,0,0,0,13,11,0,2,0,1
"E00034465",269,253,115,138,0,5,0,5,8,8,0,0,0,3
"E00034466",288,278,142,136,0,0,0,0,9,6,0,3,0,1
"E00034467",299,285,142,143,0,10,0,10,4,4,0,0,0,0
"E00034468",291,245,130,115,0,2,2,0,44,40,0,4,0,0
"E00034469",287,268,97,171,3,2,0,2,11,5,6,0,0,3
"E00034470",333,310,120,190,0,4,4,0,19,19,0,0,0,0
"E00034471",293,256,142,114,0,4,4,0,21,21,0,0,0,12
"E00034472",320,146,54,92,0,74,11,63,98,91,1,3,3,2
"E00034473",316,290,156,134,15,3,2,1,7,7,0,0,0,1
"E00034474",346,83,59,24,0,118,21,97,141,135,0,6,0,4
"E00034475",259,112,38,74,0,104,4,100,42,42,0,0,0,1
"E00034476",261,160,72,88,1,49,7,42,47,44,2,1,0,4
"E00034477",336,301,109,192,0,8,0,8,26,26,0,0,0,1
"E00034478",336,232,87,145,0,58,0,58,41,38,0,3,0,5
"E00034479",323,300,150,150,0,3,0,3,20,20,0,0,0,0
"E00034480",208,13,4,9,0,175,2,173,20,19,0,0,1,0
"E00034481",241,82,36,46,0,107,23,84,44,44,0,0,0,8
"E00034482",180,46,16,30,0,113,6,107,19,19,0,0,0,2
"E00034483",288,147,54,93,0,114,29,85,21,21,0,0,0,6
"E00034484",279,170,74,96,0,64,17,47,45,38,0,0,7,0
"E00034485",298,225,88,137,0,32,11,21,41,40,0,1,0,0
"E00165671",381,248,76,172,0,75,29,46,52,48,0,4,0,6
"E00165713",137,121,39,82,0,3,2,1,11,10,0,1,0,2
"E00165714",146,119,52,67,0,20,6,14,6,4,0,2,0,1
"E00165715",394,42,14,28,0,196,24,172,154,150,0,4,0,2
"E00165716",310,42,14,28,3,176,24,152,88,88,0,0,0,1
"E00165717",148,123,65,58,0,3,3,0,21,21,0,0,0,1
"E00165718",398,331,146,185,2,14,4,10,51,45,2,4,0,0
"E00165719",228,116,29,87,0,57,18,39,53,50,0,3,0,2
"E00165720",312,197,72,125,3,7,0,7,101,92,0,9,0,4
"E00165721",145,128,60,68,3,5,0,5,9,9,0,0,0,0
"E00165722",332,195,85,110,0,59,0,59,78,76,0,2,0,0
"E00165723",227,187,53,134,0,9,0,9,31,31,0,0,0,0
"E00165724",361,217,92,125,0,26,1,25,115,114,0,1,0,3
"E00165725",178,146,73,73,1,1,0,1,24,21,0,3,0,6
"E00165726",460,193,82,111,0,234,43,191,28,25,0,0,3,5
"E00165727",174,117,48,69,0,8,1,7,47,45,0,2,0,2
"E00165729",303,279,143,136,0,7,4,3,17,17,0,0,0,0
"E00165730",480,453,116,337,3,9,2,7,13,13,0,0,0,2
"E00165731",260,123,57,66,0,37,0,37,100,97,0,3,0,0
"E00165758",167,154,68,86,0,6,1,5,7,7,0,0,0,0
"E00165759",215,163,68,95,0,23,3,20,28,28,0,0,0,1
"E00165760",189,47,26,21,0,118,5,113,16,16,0,0,0,8
"E00165762",364,287,53,234,14,10,0,10,53,48,4,1,0,0
"E00165763",242,56,34,22,2,166,42,124,13,13,0,0,0,5
"E00176596",235,74,21,53,1,106,4,102,54,45,0,6,3,0
"E00176597",296,51,24,27,0,187,9,178,53,53,0,0,0,5
"E00176598",247,199,23,176,0,10,0,10,38,37,0,1,0,0
"E00176599",208,98,25,73,0,88,18,70,20,15,0,5,0,2
"E00176600",211,56,8,48,0,18,6,12,136,134,0,2,0,1
"E00176601",413,350,27,323,0,7,0,7,55,49,0,6,0,1
"E00176602",123,14,6,8,0,43,4,39,62,61,0,1,0,4
"E00176603",179,74,16,58,0,4,2,2,99,96,0,3,0,2
"E00176604",151,29,5,24,0,3,0,3,117,110,0,7,0,2
"E00176605",200,44,5,39,0,4,4,0,148,141,0,6,1,4
"E00176606",182,54,8,46,0,6,0,6,119,113,0,6,0,3
"E00176607",183,18,2,16,0,4,0,4,161,158,0,2,1,0
"E00176608",208,72,17,55,0,8,3,5,128,121,0,7,0,0
"E00176609",329,98,64,34,0,173,16,157,54,44,0,5,5,4
"E00176610",307,74,27,47,0,200,95,105,24,21,0,0,3,9
"E00176611",196,37,19,18,0,10,0,10,149,132,0,7,10,0
"E00176612",330,91,39,52,13,5,0,5,221,210,0,11,0,0
"E00176613",242,42,13,29,7,12,0,12,181,169,0,12,0,0
"E00176614",554,82,30,52,5,33,0,33,433,422,0,11,0,1
"E00176615",291,90,27,63,0,48,4,44,152,55,1,3,93,1
"E00176616",155,15,1,14,0,5,0,5,133,126,0,0,7,2
"E00176617",860,36,23,13,0,200,27,173,619,189,1,5,424,5
"E00176618",190,59,32,27,0,95,24,71,34,32,0,2,0,2
"E00176619",244,44,18,26,33,10,3,7,157,151,0,6,0,0
"E00176620",262,77,41,36,0,25,1,24,160,152,5,3,0,0
"E00176621",143,8,3,5,0,2,0,2,130,130,0,0,0,3
"E00176622",173,48,16,32,1,2,0,2,122,118,0,4,0,0
"E00176623",110,7,3,4,0,1,0,1,98,94,0,4,0,4
"E00176624",197,22,10,12,0,72,13,59,102,101,0,0,1,1
"E00176625",165,36,4,32,0,1,0,1,128,122,1,2,3,0
"E00176626",228,24,0,24,0,5,2,3,198,197,0,1,0,1
"E00176627",198,26,4,22,0,99,4,95,71,69,0,2,0,2
"E00176628",203,7,2,5,2,11,3,8,176,174,0,2,0,7
"E00176629",199,21,13,8,2,35,0,35,136,131,0,1,4,5
"E00176630",306,256,84,172,4,7,2,5,39,36,0,3,0,0
"E00176631",211,137,53,84,0,49,18,31,25,25,0,0,0,0
"E00176632",253,176,41,135,0,21,6,15,51,49,0,2,0,5
"E00176633",165,41,7,34,0,47,10,37,77,73,0,0,4,0
"E00176634",422,28,16,12,0,127,3,124,266,252,1,0,13,1
"E00176635",218,22,11,11,0,3,0,3,189,187,0,0,2,4
"E00176636",164,7,4,3,0,29,1,28,126,125,0,1,0,2
"E00176637",124,7,1,6,9,43,2,41,65,65,0,0,0,0
"E00176638",207,38,20,18,0,5,0,5,161,159,0,2,0,3
"E00176639",118,8,5,3,0,37,0,37,73,60,6,3,4,0
"E00176640",376,70,38,32,0,52,4,48,252,249,0,3,0,2
"E00176641",119,9,4,5,1,80,2,78,28,24,0,0,4,1
"E00176642",283,52,12,40,1,3,0,3,223,219,0,4,0,4
"E00176643",196,41,11,30,0,4,0,4,147,143,1,3,0,4
"E00176644",194,12,4,8,0,34,1,33,145,140,0,0,5,3
"E00176645",176,22,10,12,0,0,0,0,148,146,0,0,2,6
"E00176646",168,14,2,12,2,65,9,56,86,84,0,0,2,1
"E00176647",208,32,9,23,3,22,2,20,150,146,0,3,1,1
"E00176648",471,330,130,200,0,20,5,15,121,121,0,0,0,0
"E00176649",200,14,9,5,26,148,19,129,11,11,0,0,0,1
"E00176650",200,45,9,36,0,4,1,3,149,143,0,6,0,2
"E00176651",252,105,46,59,0,93,16,77,48,44,0,0,4,6
"E00176652",213,29,14,15,3,17,1,16,161,147,0,5,9,3
"E00176653",429,47,13,34,1,9,4,5,368,361,0,5,2,4
"E00176654",195,92,21,71,0,12,0,12,85,81,0,4,0,6
"E00176655",193,24,6,18,0,85,11,74,81,64,0,0,17,3
"E00176656",198,86,41,45,0,3,1,2,105,105,0,0,0,4
"E00176657",197,23,3,20,0,1,1,0,172,167,0,5,0,1
"E00176658",219,16,6,10,1,21,0,21,180,178,0,0,2,1
"E00176659",161,24,4,20,8,40,1,39,88,86,0,2,0,1
"E00176660",169,65,13,52,13,2,0,2,85,83,0,2,0,4
"E00176661",210,9,0,9,0,13,1,12,186,181,0,0,5,2
"E00176662",331,236,38,198,0,16,3,13,79,79,0,0,0,0
"E00176663",293,51,24,27,0,81,6,75,160,150,0,10,0,1
"E00176664",216,137,51,86,4,5,0,5,64,62,0,2,0,6
"E00176665",444,23,11,12,0,383,81,302,34,16,0,6,12,4
"E00176666",169,89,28,61,0,1,0,1,75,64,4,2,5,4
"E00176667",332,152,60,92,0,10,2,8,164,140,11,6,7,6
"E00176668",479,293,84,209,10,101,27,74,73,65,0,8,0,2
"E00176669",218,126,49,77,2,20,3,17,61,56,0,5,0,9
"E00176670",284,137,31,106,0,8,1,7,136,128,0,8,0,3
"E00176671",327,177,70,107,1,106,20,86,39,38,1,0,0,4
"E00176672",150,40,3,37,4,10,0,10,96,94,0,2,0,0
"E00176673",194,50,21,29,0,56,7,49,86,81,0,3,2,2
"E00176674",195,1,0,1,0,1,0,1,190,187,0,3,0,3
"E00176675",362,80,44,36,0,25,0,25,253,246,0,2,5,4
"E00176676",174,7,4,3,1,83,3,80,83,81,0,0,2,0
"E00176677",310,259,88,171,2,7,0,7,42,40,0,2,0,0
"E00176678",308,250,66,184,0,11,4,7,47,43,0,4,0,0
"E00176679",227,7,2,5,0,6,0,6,213,213,0,0,0,1
"E00176680",250,12,8,4,0,1,0,1,237,234,1,0,2,0
"E00176681",190,9,4,5,0,4,0,4,177,177,0,0,0,0
"E00176682",177,13,5,8,0,1,0,1,160,156,0,4,0,3
"E00176683",180,19,4,15,3,2,0,2,156,153,0,3,0,0
"E00176684",231,38,8,30,0,3,0,3,190,185,0,5,0,0
"E00176685",257,46,15,31,1,181,11,170,26,26,0,0,0,3
"E00176686",183,19,11,8,0,14,5,9,150,146,0,0,4,0
"E00176687",240,22,7,15,3,46,0,46,169,165,0,2,2,0
"E00176688",285,12,7,5,2,62,6,56,207,177,0,0,30,2
"E00176689",132,10,5,5,0,31,1,30,91,80,0,0,11,0
"E00176690",168,2,2,0,4,61,11,50,97,76,5,0,16,4
"E00176691",212,13,3,10,0,28,1,27,168,163,5,0,0,3
"E00176692",240,12,10,2,0,9,2,7,215,208,0,7,0,4
"E00176693",138,25,5,20,4,5,0,5,104,99,0,4,1,0
"E00176694",171,24,11,13,0,49,0,49,95,79,1,2,13,3
"E00176695",184,36,9,27,5,50,5,45,90,64,6,0,20,3
"E00176696",458,195,74,121,0,209,70,139,46,43,0,3,0,8
"E00176697",308,181,54,127,0,32,8,24,95,90,0,5,0,0
"E00176698",60,11,3,8,0,7,0,7,42,39,0,0,3,0
"E00176699",221,83,59,24,0,57,11,46,78,76,0,2,0,3
"E00176700",189,9,3,6,1,8,1,7,171,168,0,2,1,0
"E00176701",246,38,4,34,0,2,0,2,204,194,0,9,1,2
"E00176702",259,60,19,41,0,17,0,17,175,164,0,11,0,7
"E00176703",262,238,16,222,0,2,0,2,17,16,0,1,0,5
"E00176704",214,73,24,49,0,52,10,42,88,88,0,0,0,1
"E00176705",117,3,0,3,0,15,2,13,98,93,0,3,2,1
"E00176706",330,270,26,244,0,4,0,4,56,55,0,1,0,0
"E00176707",269,60,2,58,0,135,26,109,71,70,0,1,0,3
"E00176708",201,5,1,4,3,182,7,175,10,10,0,0,0,1
"E00176709",217,13,11,2,0,56,3,53,148,48,4,1,95,0
"E00176710",245,16,6,10,0,166,10,156,58,56,0,0,2,5
"E00176711",333,15,5,10,6,98,0,98,208,200,1,7,0,6
"E00176712",83,3,0,3,0,7,0,7,73,70,1,1,1,0
"E00176713",92,7,6,1,0,58,25,33,23,17,0,1,5,4
"E00176714",154,79,21,58,0,55,10,45,11,11,0,0,0,9
"E00176715",115,32,17,15,0,73,0,73,9,9,0,0,0,1
"E00176716",176,53,18,35,0,7,0,7,116,109,0,7,0,0
"E00176717",151,17,15,2,5,96,4,92,33,24,0,6,3,0
"E00176718",266,21,12,9,0,222,29,193,20,19,0,0,1,3
"E00176719",202,72,18,54,0,2,0,2,128,122,0,6,0,0
"E00176720",266,215,75,140,2,4,0,4,44,44,0,0,0,1
"E00176721",238,164,38,126,0,0,0,0,73,70,0,3,0,1
"E00176722",307,288,37,251,0,0,0,0,19,14,0,5,0,0
"E00176723",272,233,111,122,0,5,0,5,26,25,0,1,0,8
"E00176724",143,7,2,5,0,33,4,29,100,97,0,0,3,3
"E00176725",174,95,37,58,0,9,0,9,70,68,2,0,0,0
"E00176726",335,72,39,33,0,95,5,90,168,162,0,2,4,0
"E00176727",332,111,23,88,7,95,23,72,119,109,3,6,1,0
"E00176728",166,70,29,41,0,45,17,28,51,49,0,0,2,0
"E00176729",272,199,53,146,0,6,0,6,65,63,0,2,0,2
"E00176730",154,64,25,39,0,5,0,5,84,82,0,2,0,1
"E00176731",139,5,0,5,1,63,1,62,65,65,0,0,0,5
"E00176732",361,95,50,45,3,116,5,111,143,135,0,2,6,4
"E00176733",202,31,12,19,0,84,7,77,82,82,0,0,0,5
"E00176734",109,15,6,9,0,9,2,7,85,79,0,6,0,0
"E00176735",197,11,1,10,2,5,0,5,178,167,3,7,1,1
"E00176736",215,33,10,23,0,9,4,5,169,164,0,5,0,4
"E00176737",185,18,5,13,1,7,0,7,159,157,0,2,0,0
"E00176738",111,9,3,6,0,92,13,79,9,5,0,1,3,1
"E00176739",213,11,3,8,0,7,0,7,194,190,0,2,2,1
"E00176740",156,12,11,1,0,52,1,51,92,90,1,0,1,0
"E00176741",225,56,25,31,0,157,25,132,11,9,0,2,0,1
"E00176742",205,81,4,77,0,3,0,3,117,116,0,1,0,4
"E00176743",230,73,7,66,2,54,2,52,101,97,0,4,0,0
"E00176744",158,18,11,7,0,54,12,42,73,73,0,0,0,13
"E00176745",265,107,38,69,0,32,0,32,124,120,4,0,0,2
"E00176746",563,125,24,101,4,240,37,203,184,179,0,5,0,10
"E00176747",138,38,7,31,0,61,8,53,39,39,0,0,0,0
"E00176748",191,15,5,10,4,1,0,1,169,165,0,4,0,2
"E00176749",247,28,12,16,0,2,0,2,216,204,5,4,3,1
"E00176750",243,150,32,118,0,28,9,19,62,58,0,4,0,3
"E00176751",226,153,31,122,15,8,0,8,47,45,0,2,0,3
"E00176752",280,39,25,14,8,174,15,159,55,53,0,2,0,4
"E00176753",231,32,16,16,0,173,53,120,26,21,0,0,5,0
"E00176754",244,95,35,60,0,121,29,92,23,23,0,0,0,5
"E00176755",280,113,44,69,1,138,13,125,25,22,0,3,0,3
"E00176756",206,55,7,48,0,2,0,2,146,132,0,4,10,3
"E00176757",200,52,10,42,0,46,5,41,99,95,0,4,0,3
"E00176758",104,0,0,0,0,79,17,62,25,24,0,0,1,0
"E00176759",248,36,17,19,0,183,45,138,29,28,0,0,1,0
"E00176760",177,58,21,37,0,102,31,71,15,10,0,0,5,2
"E00176761",230,148,10,138,0,39,12,27,39,39,0,0,0,4
"E00176762",217,30,3,27,0,172,50,122,13,8,0,0,5,2
"E00176763",111,8,3,5,0,91,35,56,11,11,0,0,0,1
"E00176764",257,67,28,39,0,150,26,124,33,31,0,2,0,7
"E00176765",230,37,8,29,1,5,0,5,187,169,6,2,10,0
"E00176766",173,24,10,14,0,8,0,8,140,135,0,5,0,1
"E00176767",211,80,28,52,0,114,35,79,16,12,0,0,4,1
"E00176768",362,126,38,88,2,196,44,152,31,27,0,0,4,7
"E00176769",162,5,0,5,67,30,2,28,60,57,0,3,0,0
"E00176770",156,120,36,84,0,6,2,4,29,29,0,0,0,1
"E00176771",124,118,49,69,0,0,0,0,6,5,0,0,1,0
"E00176772",252,225,113,112,0,12,12,0,15,15,0,0,0,0
"E00176773",169,68,6,62,0,2,1,1,97,97,0,0,0,2
"E00176774",102,36,11,25,0,52,9,43,9,9,0,0,0,5
