"GeographyCode","QS405EW0001","QS405EW0002","QS405EW0003","QS405EW0004","QS405EW0005","QS405EW0006","QS405EW0007","QS405EW0008","QS405EW0009","QS405EW0010","QS405EW0011","QS405EW0012","QS405EW0013","QS405EW0014"
"E00032987",87,3,0,3,0,51,3,48,32,32,0,0,0,1
"E00032988",200,23,14,9,0,130,1,129,47,45,0,0,2,0
"E00032989",232,11,3,8,0,176,4,172,45,42,0,1,2,0
"E00032990",219,22,8,14,13,127,8,119,56,55,0,1,0,1
"E00032991",219,10,4,6,0,133,6,127,74,69,0,2,3,2
"E00032992",165,10,5,5,0,134,8,126,20,18,0,2,0,1
"E00032993",166,28,9,19,1,61,13,48,72,62,0,8,2,4
"E00032994",63,3,0,3,0,46,16,30,12,10,0,2,0,2
"E00032995",149,38,25,13,0,81,6,75,26,24,0,2,0,4
"E00032996",181,25,5,20,0,145,51,94,6,4,0,0,2,5
"E00032997",106,40,20,20,1,33,1,32,29,24,0,5,0,3
"E00032998",164,39,16,23,0,64,13,51,56,53,0,3,0,5
"E00032999",236,17,14,3,0,126,8,118,90,87,0,3,0,3
"E00033000",87,5,0,5,0,78,4,74,2,2,0,0,0,2
"E00033002",129,35,15,20,0,49,6,43,39,33,0,4,2,6
"E00033004",167,99,47,52,0,3,0,3,63,58,1,2,2,2
"E00033005",176,30,8,22,1,119,18,101,20,18,0,0,2,6
"E00033006",120,47,25,22,0,49,2,47,24,23,0,1,0,0
"E00033007",155,7,2,5,8,120,15,105,16,13,0,0,3,4
"E00033008",147,17,3,14,1,117,51,66,11,10,0,0,1,1
"E00033012",104,78,43,35,0,1,0,1,24,18,0,2,4,1
"E00033013",115,37,22,15,0,30,1,29,47,45,0,1,1,1
"E00033015",109,28,15,13,2,3,0,3,74,69,0,5,0,2
"E00033016",226,66,35,31,6,43,2,41,109,98,0,3,8,2
"E00033018",72,10,7,3,2,25,0,25,35,35,0,0,0,0
"E00033019",218,5,1,4,1,155,5,150,57,56,1,0,0,0
"E00033020",143,14,2,12,4,49,2,47,75,63,1,5,6,1
"E00033021",134,12,4,8,23,85,12,73,13,9,0,1,3,1
"E00033023",149,18,14,4,0,86,3,83,38,35,2,0,1,7
"E00033024",104,11,4,7,0,81,20,61,9,8,0,0,1,3
"E00033025",135,104,44,60,0,13,0,13,16,14,0,2,0,2
"E00033026",90,87,36,51,0,0,0,0,1,1,0,0,0,2
"E00033027",200,78,46,32,0,19,0,19,103,98,0,4,1,0
"E00033029",111,63,29,34,1,9,0,9,37,34,1,2,0,1
"E00033030",95,78,46,32,0,3,3,0,14,13,0,1,0,0
"E00033031",130,106,46,60,1,5,2,3,18,15,0,3,0,0
"E00033032",238,39,15,24,0,42,2,40,155,151,0,3,1,2
"E00033033",193,36,7,29,0,35,0,35,120,117,0,3,0,2
"E00033034",201,64,23,41,0,10,0,10,126,120,0,6,0,1
"E00033035",159,49,20,29,1,67,0,67,41,40,0,1,0,1
"E00033036",128,32,12,20,1,55,0,55,40,38,0,2,0,0
"E00033037",153,99,70,29,0,6,0,6,47,45,0,2,0,1
"E00033038",110,17,6,11,0,35,1,34,56,52,0,4,0,2
"E00033040",132,63,27,36,2,34,4,30,33,30,0,3,0,0
"E00033041",110,105,52,53,0,1,0,1,4,4,0,0,0,0
"E00033042",98,87,46,41,0,1,0,1,10,8,2,0,0,0
"E00033043",112,76,33,43,0,1,0,1,34,26,3,5,0,1
"E00033044",92,84,52,32,0,0,0,0,7,5,0,0,2,1
"E00033045",132,5,3,2,0,119,0,119,8,7,0,1,0,0
"E00033046",121,96,77,19,0,3,0,3,21,21,0,0,0,1
"E00033047",106,101,47,54,0,3,0,3,1,1,0,0,0,1
"E00033048",100,92,52,40,0,4,4,0,4,3,0,1,0,0
"E00033049",154,102,27,75,1,5,0,5,44,44,0,0,0,2
"E00033050",84,83,38,45,0,1,1,0,0,0,0,0,0,0
"E00033051",167,66,26,40,0,5,1,4,93,90,0,2,1,3
"E00033052",144,67,27,40,0,11,0,11,65,64,0,1,0,1
"E00033053",111,85,29,56,0,5,1,4,21,19,0,2,0,0
"E00033054",76,24,7,17,0,51,0,51,1,1,0,0,0,0
"E00033055",106,82,25,57,0,2,0,2,21,17,0,2,2,1
"E00033056",123,106,32,74,0,1,0,1,16,15,0,1,0,0
"E00033057",122,93,45,48,0,5,2,3,24,16,0,8,0,0
"E00033059",149,71,29,42,0,59,1,58,17,16,0,0,1,2
"E00033060",101,86,64,22,0,0,0,0,11,8,0,2,1,4
"E00033061",91,77,41,36,1,3,0,3,10,9,0,1,0,0
"E00033062",105,100,58,42,0,1,1,0,3,3,0,0,0,1
"E00033063",101,96,55,41,0,2,0,2,3,3,0,0,0,0
"E00033064",97,91,42,49,0,0,0,0,6,5,0,1,0,0
"E00033065",120,110,53,57,0,4,1,3,6,6,0,0,0,0
"E00033066",155,43,10,33,0,47,0,47,65,64,0,1,0,0
"E00033067",184,37,13,24,0,42,0,42,105,103,2,0,0,0
"E00033068",203,52,18,34,0,11,2,9,138,134,0,4,0,2
"E00033069",164,25,8,17,1,44,0,44,93,89,0,4,0,1
"E00033070",190,33,11,22,0,89,8,81,66,62,0,2,2,2
"E00033071",141,66,26,40,0,29,2,27,46,44,0,2,0,0
"E00033072",167,30,7,23,1,53,5,48,81,77,1,2,1,2
"E00033073",192,15,2,13,1,52,0,52,123,120,0,2,1,1
"E00033074",179,22,6,16,1,119,6,113,37,34,0,3,0,0
"E00033075",210,10,4,6,0,166,9,157,33,28,0,3,2,1
"E00033076",152,115,62,53,0,2,1,1,30,29,0,0,1,5
"E00033077",185,46,17,29,2,54,0,54,82,77,0,5,0,1
"E00033078",176,77,43,34,0,52,3,49,45,43,0,2,0,2
"E00033079",116,51,21,30,0,35,1,34,30,26,0,4,0,0
"E00033080",150,12,6,6,0,129,4,125,8,8,0,0,0,1
"E00033081",127,86,32,54,2,9,1,8,28,27,0,1,0,2
"E00033082",122,117,69,48,0,2,0,2,3,1,0,1,1,0
"E00033083",122,109,55,54,0,0,0,0,12,11,0,1,0,1
"E00033084",148,87,45,42,0,48,1,47,9,8,1,0,0,4
"E00033085",143,95,45,50,0,28,9,19,18,17,0,1,0,2
"E00033086",122,118,74,44,0,0,0,0,4,4,0,0,0,0
"E00033087",149,113,44,69,0,23,5,18,12,12,0,0,0,1
"E00033088",101,73,38,35,1,21,5,16,4,2,0,2,0,2
"E00033089",124,75,35,40,0,38,11,27,8,7,0,1,0,3
"E00033090",139,93,37,56,0,38,14,24,8,8,0,0,0,0
"E00033091",126,116,56,60,0,4,1,3,3,2,0,1,0,3
"E00033092",127,121,66,55,0,0,0,0,6,5,0,1,0,0
"E00033093",158,116,45,71,1,10,5,5,28,25,0,3,0,3
"E00033094",136,108,62,46,0,12,3,9,16,15,0,1,0,0
"E00033095",164,128,63,65,0,5,1,4,29,24,1,4,0,2
"E00033096",110,107,65,42,0,0,0,0,3,2,0,1,0,0
"E00033097",119,57,25,32,0,54,15,39,8,8,0,0,0,0
"E00033098",113,102,58,44,0,2,0,2,9,8,0,1,0,0
"E00033099",94,36,20,16,1,54,7,47,2,2,0,0,0,1
"E00033100",138,76,33,43,0,48,13,35,12,6,0,6,0,2
"E00033101",96,90,59,31,2,1,0,1,2,2,0,0,0,1
"E00033102",207,140,53,87,1,29,5,24,35,33,0,2,0,2
"E00033103",117,75,32,43,0,30,6,24,7,7,0,0,0,5
"E00033104",109,73,38,35,0,27,12,15,8,7,0,1,0,1
"E00033105",118,113,69,44,0,1,0,1,3,2,0,1,0,1
"E00033106",125,56,22,34,0,52,15,37,14,13,0,1,0,3
"E00033107",121,103,46,57,0,9,1,8,7,6,0,0,1,2
"E00033108",119,85,33,52,0,21,8,13,12,12,0,0,0,1
"E00033109",123,107,60,47,1,0,0,0,14,11,0,3,0,1
"E00033110",142,116,58,58,0,5,1,4,21,21,0,0,0,0
"E00033112",115,112,58,54,0,0,0,0,3,3,0,0,0,0
"E00033113",117,97,56,41,0,1,0,1,19,19,0,0,0,0
"E00033114",113,112,58,54,0,1,0,1,0,0,0,0,0,0
"E00033115",92,73,48,25,1,1,0,1,17,15,0,2,0,0
"E00033116",101,53,44,9,0,35,4,31,12,11,1,0,0,1
"E00033117",154,124,62,62,0,23,0,23,6,5,0,1,0,1
"E00033118",129,123,63,60,0,1,0,1,4,3,0,1,0,1
"E00033119",109,102,58,44,0,0,0,0,6,5,0,1,0,1
"E00033120",132,105,49,56,5,2,0,2,20,19,0,1,0,0
"E00033121",119,87,59,28,1,24,2,22,3,3,0,0,0,4
"E00033122",121,107,67,40,1,2,1,1,8,7,0,1,0,3
"E00033123",123,116,84,32,0,3,0,3,2,1,0,1,0,2
"E00033124",120,106,48,58,0,6,0,6,7,7,0,0,0,1
"E00033125",111,38,14,24,0,60,11,49,11,11,0,0,0,2
"E00033126",111,102,61,41,0,3,1,2,6,5,0,1,0,0
"E00033127",194,115,36,79,0,51,12,39,21,19,0,2,0,7
"E00033128",111,73,35,38,0,33,5,28,3,1,0,0,2,2
"E00033129",108,99,64,35,0,0,0,0,8,7,0,1,0,1
"E00033130",126,120,58,62,0,0,0,0,6,6,0,0,0,0
"E00033131",130,77,39,38,0,45,8,37,7,5,0,2,0,1
"E00033132",158,115,48,67,1,6,0,6,35,31,0,4,0,1
"E00033133",144,12,5,7,0,122,4,118,7,7,0,0,0,3
"E00033134",111,46,25,21,0,15,3,12,48,43,0,5,0,2
"E00033135",183,94,43,51,0,7,3,4,81,78,1,1,1,1
"E00033136",99,41,24,17,1,31,2,29,21,19,0,2,0,5
"E00033137",167,35,19,16,0,66,4,62,66,55,0,9,2,0
"E00033138",113,21,12,9,1,24,0,24,64,62,1,1,0,3
"E00033139",149,64,39,25,0,70,6,64,14,11,0,3,0,1
"E00033140",94,67,32,35,0,2,1,1,25,24,0,1,0,0
"E00033141",85,56,36,20,1,2,2,0,26,23,0,3,0,0
"E00033142",117,69,29,40,0,1,0,1,42,37,0,4,1,5
"E00033143",127,47,18,29,0,8,1,7,69,67,0,2,0,3
"E00033144",126,45,24,21,0,7,2,5,72,71,0,1,0,2
"E00033145",122,69,31,38,0,3,1,2,47,45,0,0,2,3
"E00033146",124,68,27,41,1,3,0,3,52,51,0,1,0,0
"E00033147",127,106,52,54,0,2,0,2,16,16,0,0,0,3
"E00033148",116,74,34,40,0,3,0,3,38,38,0,0,0,1
"E00033149",98,43,24,19,1,9,3,6,45,44,0,1,0,0
"E00033150",146,53,22,31,0,9,1,8,81,81,0,0,0,3
"E00033151",125,40,26,14,0,31,2,29,52,52,0,0,0,2
"E00033152",146,50,24,26,2,15,4,11,78,74,0,2,2,1
"E00033153",167,105,54,51,0,2,1,1,58,56,0,2,0,2
"E00033154",102,22,17,5,1,10,2,8,69,69,0,0,0,0
"E00033155",155,82,44,38,0,3,0,3,67,64,0,3,0,3
"E00033156",122,44,28,16,0,20,0,20,57,53,0,4,0,1
"E00033157",140,54,27,27,0,24,2,22,60,58,0,0,2,2
"E00033158",130,45,16,29,0,23,1,22,60,58,0,2,0,2
"E00033159",87,22,10,12,0,32,7,25,31,29,0,0,2,2
"E00033160",167,56,32,24,0,41,1,40,61,52,0,5,4,9
"E00033161",137,63,20,43,1,55,0,55,17,16,0,1,0,1
"E00033162",131,19,10,9,0,59,3,56,50,45,0,4,1,3
"E00033163",136,23,10,13,0,54,3,51,54,52,0,0,2,5
"E00033164",152,105,37,68,0,1,0,1,45,40,0,4,1,1
"E00033165",117,24,10,14,0,79,22,57,8,8,0,0,0,6
"E00033166",113,40,32,8,0,66,21,45,4,4,0,0,0,3
"E00033167",130,86,37,49,0,2,0,2,42,41,0,0,1,0
"E00033168",122,99,52,47,0,9,2,7,14,12,0,2,0,0
"E00033169",122,105,51,54,0,2,1,1,14,11,0,3,0,1
"E00033170",142,116,48,68,1,3,0,3,21,19,0,2,0,1
"E00033171",136,112,40,72,1,5,0,5,18,17,0,1,0,0
"E00033172",122,18,9,9,0,78,0,78,26,25,0,1,0,0
"E00033173",129,103,40,63,0,11,0,11,12,10,0,2,0,3
"E00033174",114,10,4,6,0,96,8,88,6,5,0,1,0,2
"E00033175",107,69,31,38,1,27,6,21,9,9,0,0,0,1
"E00033176",99,41,19,22,0,27,0,27,31,29,0,2,0,0
"E00033177",130,98,40,58,0,5,3,2,25,25,0,0,0,2
"E00033178",88,30,13,17,1,28,0,28,25,23,0,2,0,4
"E00033179",136,43,13,30,0,61,10,51,29,26,0,3,0,3
"E00033181",155,54,24,30,0,23,1,22,78,77,0,1,0,0
"E00033182",184,32,14,18,3,48,1,47,97,97,0,0,0,4
"E00033183",207,43,17,26,1,30,0,30,133,131,0,2,0,0
"E00033185",117,48,19,29,0,1,0,1,68,66,0,0,2,0
"E00033186",105,25,10,15,2,13,1,12,65,63,0,1,1,0
"E00033187",129,27,9,18,2,23,0,23,76,73,1,2,0,1
"E00033188",113,52,28,24,2,17,1,16,42,35,0,5,2,0
"E00033189",208,31,22,9,0,104,2,102,66,60,1,4,1,7
"E00033190",226,36,20,16,0,106,8,98,76,71,0,2,3,8
"E00033191",128,39,23,16,1,13,2,11,73,69,0,4,0,2
"E00033192",118,33,16,17,0,5,0,5,79,76,0,2,1,1
"E00033193",114,62,27,35,0,4,0,4,47,41,0,4,2,1
"E00033194",117,41,18,23,1,11,0,11,61,54,0,7,0,3
"E00033195",105,57,21,36,1,4,1,3,42,39,0,3,0,1
"E00033196",137,13,6,7,0,31,10,21,92,92,0,0,0,1
"E00033197",236,44,15,29,2,153,3,150,34,32,0,2,0,3
"E00033198",135,69,34,35,3,8,0,8,55,55,0,0,0,0
"E00033199",137,17,15,2,1,110,3,107,7,7,0,0,0,2
"E00033200",126,13,6,7,1,88,1,87,22,22,0,0,0,2
"E00033201",91,41,15,26,0,11,0,11,39,36,0,3,0,0
"E00033202",98,46,20,26,0,5,0,5,46,41,0,5,0,1
"E00033203",101,62,29,33,0,3,0,3,36,35,0,1,0,0
"E00033204",105,63,28,35,0,1,0,1,40,35,0,3,2,1
"E00033206",117,23,14,9,0,53,1,52,38,34,4,0,0,3
"E00033207",179,16,8,8,0,101,7,94,56,54,2,0,0,6
"E00033208",143,9,6,3,1,66,5,61,62,59,0,1,2,5
"E00033209",208,19,12,7,0,129,12,117,56,52,3,1,0,4
"E00033210",133,17,9,8,2,62,3,59,51,50,0,0,1,1
"E00033211",145,38,24,14,0,60,5,55,43,40,0,2,1,4
"E00033212",123,32,18,14,3,57,1,56,30,30,0,0,0,1
"E00033213",136,58,41,17,3,0,0,0,73,70,0,3,0,2
"E00033214",223,51,33,18,2,72,2,70,97,89,1,3,4,1
"E00033215",147,19,9,10,4,75,6,69,48,44,2,0,2,1
"E00033216",150,29,10,19,9,62,3,59,50,50,0,0,0,0
"E00033217",158,38,26,12,0,24,1,23,93,93,0,0,0,3
"E00033218",106,69,30,39,0,8,0,8,28,28,0,0,0,1
"E00033219",181,57,21,36,0,46,2,44,77,70,0,7,0,1
"E00033220",135,43,19,24,0,5,0,5,87,81,0,6,0,0
"E00033221",170,4,2,2,0,80,8,72,83,83,0,0,0,3
"E00033222",135,2,1,1,0,116,2,114,17,16,0,1,0,0
"E00033223",171,15,7,8,2,34,1,33,120,119,0,0,1,0
"E00033224",148,22,8,14,4,102,5,97,16,16,0,0,0,4
"E00033225",160,23,11,12,1,86,5,81,45,43,0,2,0,5
"E00033226",187,36,21,15,1,112,12,100,34,34,0,0,0,4
"E00033227",136,9,4,5,0,114,1,113,13,13,0,0,0,0
"E00033228",208,29,13,16,1,104,16,88,71,71,0,0,0,3
"E00033229",128,108,61,47,0,6,2,4,13,11,0,2,0,1
"E00033230",114,95,61,34,0,8,1,7,11,9,0,2,0,0
"E00033231",113,35,25,10,0,38,6,32,37,37,0,0,0,3
"E00033235",122,21,11,10,1,78,9,69,19,18,0,1,0,3
"E00033237",146,10,5,5,0,133,9,124,3,3,0,0,0,0
"E00033238",182,45,30,15,0,118,7,111,18,16,0,1,1,1
"E00033242",104,22,8,14,0,82,28,54,0,0,0,0,0,0
"E00033245",167,25,11,14,0,124,13,111,17,16,0,1,0,1
"E00033246",121,44,22,22,0,56,7,49,20,20,0,0,0,1
"E00033247",148,67,40,27,0,41,2,39,38,36,0,1,1,2
"E00033248",250,6,4,2,2,230,67,163,6,5,0,0,1,6
"E00033249",132,44,20,24,0,59,8,51,28,25,0,3,0,1
"E00033250",126,29,20,9,0,65,7,58,30,28,0,0,2,2
"E00033251",106,15,6,9,0,57,5,52,34,34,0,0,0,0
"E00033252",169,18,12,6,1,133,16,117,16,16,0,0,0,1
"E00033253",132,24,10,14,1,73,11,62,32,31,0,1,0,2
"E00033254",152,41,20,21,0,90,14,76,18,16,1,1,0,3
"E00033255",126,54,25,29,0,64,18,46,6,4,0,2,0,2
"E00033256",100,64,39,25,2,23,9,14,9,5,0,3,1,2
"E00033257",180,79,44,35,0,60,22,38,36,36,0,0,0,5
"E00033258",157,15,8,7,0,126,39,87,8,7,0,0,1,8
"E00033259",80,20,9,11,0,34,1,33,26,26,0,0,0,0
"E00033260",129,46,29,17,2,45,4,41,36,36,0,0,0,0
"E00033261",110,34,17,17,0,45,7,38,30,30,0,0,0,1
"E00033262",96,20,17,3,1,23,0,23,50,49,0,1,0,2
"E00033263",89,18,10,8,0,30,0,30,37,37,0,0,0,4
"E00033264",147,37,24,13,0,95,19,76,12,10,0,1,1,3
"E00033265",126,62,32,30,0,60,17,43,4,4,0,0,0,0
"E00033266",147,80,40,40,0,56,15,41,8,8,0,0,0,3
"E00033267",141,44,17,27,1,67,1,66,25,24,0,1,0,4
"E00033268",121,95,50,45,1,13,6,7,10,10,0,0,0,2
"E00033269",92,58,28,30,0,27,10,17,5,5,0,0,0,2
"E00033270",128,109,45,64,0,11,4,7,7,6,0,1,0,1
"E00033271",126,115,43,72,0,1,1,0,9,9,0,0,0,1
"E00033272",120,107,53,54,0,4,1,3,9,9,0,0,0,0
"E00033274",122,66,26,40,0,45,21,24,10,9,0,0,1,1
"E00033275",142,73,25,48,1,62,6,56,6,5,0,1,0,0
"E00033276",127,54,14,40,0,34,9,25,32,30,0,2,0,7
"E00033277",99,51,28,23,0,37,13,24,11,11,0,0,0,0
"E00033278",107,69,27,42,0,10,0,10,25,24,0,0,1,3
"E00033279",139,66,24,42,1,34,0,34,38,36,2,0,0,0
"E00033281",136,82,33,49,1,20,0,20,31,29,0,2,0,2
"E00033282",125,82,35,47,0,27,5,22,14,14,0,0,0,2
"E00033283",118,85,45,40,0,29,5,24,4,4,0,0,0,0
"E00033284",182,9,4,5,0,147,38,109,22,17,0,5,0,4
"E00033285",135,83,38,45,0,21,1,20,30,30,0,0,0,1
"E00033286",128,32,18,14,0,80,7,73,15,15,0,0,0,1
"E00033287",115,93,29,64,0,3,2,1,19,18,0,1,0,0
"E00033288",121,107,39,68,0,1,0,1,13,12,0,0,1,0
"E00033289",105,91,35,56,0,1,0,1,11,7,0,3,1,2
"E00033290",88,78,21,57,0,4,1,3,6,6,0,0,0,0
"E00033291",185,132,37,95,0,21,5,16,32,29,1,2,0,0
"E00033292",106,81,29,52,1,6,1,5,18,14,2,2,0,0
"E00033293",145,61,18,43,6,67,6,61,11,10,0,1,0,0
"E00033294",130,42,22,20,1,22,1,21,64,61,0,2,1,1
"E00033295",108,96,47,49,0,3,0,3,8,7,0,1,0,1
"E00033296",111,94,49,45,0,1,0,1,15,13,1,0,1,1
"E00033297",143,61,22,39,12,53,12,41,16,13,0,3,0,1
"E00033298",129,76,33,43,0,44,17,27,4,4,0,0,0,5
"E00033299",117,87,49,38,0,18,2,16,6,4,0,1,1,6
"E00033300",112,58,25,33,1,43,13,30,9,9,0,0,0,1
"E00033301",120,51,15,36,0,54,13,41,14,13,0,1,0,1
"E00033302",105,43,23,20,0,57,18,39,5,5,0,0,0,0
"E00033304",102,67,31,36,0,22,6,16,12,11,0,0,1,1
"E00033305",121,78,36,42,2,36,8,28,3,3,0,0,0,2
"E00033306",122,68,37,31,0,41,14,27,9,5,0,2,2,4
"E00033307",124,41,15,26,0,69,21,48,10,10,0,0,0,4
"E00033308",122,66,29,37,0,43,12,31,13,13,0,0,0,0
"E00033309",135,41,16,25,0,74,23,51,17,17,0,0,0,3
"E00033310",127,52,25,27,0,59,10,49,16,14,0,2,0,0
"E00033312",133,67,36,31,0,51,16,35,12,11,0,0,1,3
"E00033313",137,59,29,30,0,69,19,50,5,5,0,0,0,4
"E00033314",130,90,38,52,0,34,9,25,5,3,0,1,1,1
"E00033315",130,85,44,41,0,35,13,22,6,3,0,2,1,4
"E00033316",144,123,52,71,0,2,0,2,17,16,0,1,0,2
"E00033317",152,134,53,81,0,7,0,7,9,9,0,0,0,2
"E00033318",153,71,27,44,0,65,22,43,14,12,0,2,0,3
"E00033319",164,151,71,80,0,1,0,1,9,8,0,1,0,3
"E00033320",130,122,60,62,0,0,0,0,8,7,0,1,0,0
"E00033322",118,111,55,56,0,2,1,1,4,4,0,0,0,1
"E00033323",107,105,60,45,0,0,0,0,2,1,0,1,0,0
"E00033324",113,107,50,57,0,1,1,0,5,5,0,0,0,0
"E00033326",106,104,54,50,0,0,0,0,1,1,0,0,0,1
"E00033327",124,117,60,57,0,0,0,0,7,7,0,0,0,0
"E00033328",119,39,15,24,0,68,17,51,8,8,0,0,0,4
"E00033329",131,114,50,64,0,1,0,1,14,13,0,0,1,2
"E00033330",130,118,62,56,0,1,1,0,11,11,0,0,0,0
"E00033331",134,123,66,57,0,3,0,3,8,7,0,1,0,0
"E00033332",108,99,40,59,0,1,0,1,7,6,0,1,0,1
"E00033333",121,113,58,55,0,1,1,0,7,4,0,3,0,0
"E00033334",108,93,45,48,0,1,0,1,13,12,0,1,0,1
"E00033335",108,104,60,44,0,1,0,1,3,3,0,0,0,0
"E00033336",121,113,53,60,0,1,1,0,7,6,0,1,0,0
"E00033337",85,78,43,35,0,2,0,2,3,3,0,0,0,2
"E00033338",90,86,38,48,0,1,0,1,2,2,0,0,0,1
"E00033339",132,105,50,55,0,3,0,3,23,22,0,1,0,1
"E00033340",103,102,37,65,0,0,0,0,1,0,0,0,1,0
"E00033341",115,110,55,55,0,1,0,1,4,4,0,0,0,0
"E00033342",126,120,71,49,0,2,1,1,4,4,0,0,0,0
"E00033343",96,88,35,53,0,0,0,0,7,6,0,1,0,1
"E00033344",139,123,58,65,0,1,0,1,15,10,4,1,0,0
"E00033345",129,119,56,63,1,2,0,2,6,6,0,0,0,1
"E00033346",124,90,49,41,0,2,0,2,30,27,1,2,0,2
"E00033347",121,106,55,51,0,1,0,1,11,9,0,2,0,3
"E00033348",112,103,54,49,0,2,1,1,4,2,0,2,0,3
"E00033349",154,53,28,25,6,59,6,53,36,35,0,0,1,0
"E00033350",122,113,58,55,0,2,0,2,7,7,0,0,0,0
"E00033351",124,78,42,36,0,33,13,20,9,8,0,1,0,4
"E00033352",108,88,37,51,0,3,0,3,16,14,0,1,1,1
"E00033353",103,91,47,44,0,1,1,0,10,9,0,0,1,1
"E00033354",150,21,8,13,0,115,25,90,4,4,0,0,0,10
"E00033355",113,86,27,59,0,1,0,1,26,26,0,0,0,0
"E00033356",137,110,43,67,2,15,5,10,9,9,0,0,0,1
"E00033357",125,66,38,28,1,47,20,27,9,8,0,1,0,2
"E00033358",95,48,28,20,0,36,18,18,10,9,0,0,1,1
"E00033359",161,90,43,47,1,8,3,5,61,60,0,1,0,1
"E00033360",155,130,73,57,0,13,5,8,11,8,0,3,0,1
"E00033361",174,136,48,88,0,3,0,3,34,33,0,0,1,1
"E00033362",106,95,26,69,0,1,0,1,10,9,0,1,0,0
"E00033363",87,68,23,45,0,2,0,2,17,15,0,1,1,0
"E00033364",134,122,66,56,0,1,1,0,10,6,0,4,0,1
"E00033365",172,145,65,80,0,2,1,1,20,20,0,0,0,5
"E00033366",108,98,55,43,0,0,0,0,10,10,0,0,0,0
"E00033367",137,81,26,55,0,4,0,4,52,48,0,3,1,0
"E00033368",124,90,47,43,0,2,0,2,31,27,0,4,0,1
"E00033369",137,122,50,72,0,4,0,4,10,10,0,0,0,1
"E00033370",141,86,41,45,1,29,0,29,22,18,0,4,0,3
"E00033371",124,104,51,53,0,1,0,1,19,19,0,0,0,0
"E00033372",112,84,29,55,1,2,1,1,24,24,0,0,0,1
"E00033373",181,142,68,74,1,6,0,6,32,31,0,1,0,0
"E00033374",140,107,56,51,1,4,0,4,25,23,0,2,0,3
"E00033375",140,122,75,47,0,0,0,0,15,15,0,0,0,3
"E00033376",135,123,77,46,0,3,0,3,7,5,0,2,0,2
"E00033377",133,108,49,59,0,1,0,1,23,21,0,2,0,1
"E00033378",137,117,68,49,0,2,0,2,18,16,0,2,0,0
"E00033379",130,92,33,59,0,1,0,1,37,34,0,3,0,0
"E00033380",106,92,41,51,0,3,1,2,11,11,0,0,0,0
"E00033381",130,110,83,27,2,2,1,1,13,13,0,0,0,3
"E00033382",123,112,48,64,0,2,0,2,9,9,0,0,0,0
"E00033383",133,114,52,62,0,0,0,0,19,14,0,5,0,0
"E00033384",146,125,63,62,0,1,0,1,18,17,0,1,0,2
"E00033385",156,107,46,61,0,9,1,8,40,35,0,4,1,0
"E00033386",140,101,34,67,1,23,0,23,15,15,0,0,0,0
"E00033387",122,40,16,24,0,28,2,26,54,52,0,2,0,0
"E00033388",162,26,11,15,9,102,1,101,22,19,0,3,0,3
"E00033389",118,99,33,66,0,9,2,7,9,6,0,1,2,1
"E00033391",164,66,27,39,2,35,10,25,60,55,0,5,0,1
"E00033392",149,46,19,27,0,17,3,14,83,79,0,4,0,3
"E00033394",139,62,22,40,0,34,7,27,43,41,0,1,1,0
"E00033395",156,59,28,31,0,10,5,5,86,81,0,4,1,1
"E00033396",126,102,58,44,0,7,0,7,13,11,0,2,0,4
"E00033397",125,109,38,71,0,8,5,3,5,5,0,0,0,3
"E00033399",128,116,52,64,0,1,0,1,11,8,0,3,0,0
"E00033400",118,115,49,66,0,1,0,1,2,2,0,0,0,0
"E00033401",102,91,38,53,0,2,0,2,8,8,0,0,0,1
"E00033402",134,74,32,42,3,8,1,7,49,46,0,3,0,0
"E00033403",144,123,57,66,0,1,0,1,16,15,0,1,0,4
"E00033404",162,76,43,33,0,20,1,19,64,53,2,9,0,2
"E00033405",129,102,40,62,1,1,1,0,23,22,0,1,0,2
"E00033406",126,109,49,60,0,0,0,0,15,15,0,0,0,2
"E00033407",138,66,33,33,1,7,1,6,63,62,0,1,0,1
"E00033408",123,78,31,47,0,4,1,3,41,36,0,3,2,0
"E00033409",166,139,107,32,1,1,0,1,21,20,1,0,0,4
"E00033410",121,84,34,50,0,2,0,2,35,34,0,1,0,0
"E00033411",119,108,57,51,0,1,0,1,10,10,0,0,0,0
"E00033412",146,97,43,54,0,2,0,2,46,46,0,0,0,1
"E00033413",111,45,20,25,0,4,0,4,62,60,0,2,0,0
"E00033414",135,86,33,53,0,3,0,3,42,40,0,1,1,4
"E00033415",94,88,35,53,0,3,0,3,2,2,0,0,0,1
"E00033416",144,84,26,58,0,7,0,7,53,51,0,1,1,0
"E00033417",144,104,40,64,0,2,0,2,36,32,0,3,1,2
"E00033418",144,131,66,65,0,4,1,3,8,6,0,0,2,1
"E00033419",119,112,57,55,0,3,1,2,3,3,0,0,0,1
"E00033420",155,97,44,53,0,7,2,5,48,45,0,3,0,3
"E00033421",128,71,25,46,0,0,0,0,56,52,0,4,0,1
"E00033422",172,160,76,84,0,3,2,1,9,9,0,0,0,0
"E00033423",126,89,34,55,0,1,0,1,36,36,0,0,0,0
"E00033424",134,99,40,59,0,4,1,3,30,29,0,1,0,1
"E00033425",124,87,26,61,0,2,0,2,33,29,0,4,0,2
"E00033426",121,97,46,51,0,2,2,0,22,22,0,0,0,0
"E00033427",105,83,45,38,0,1,0,1,20,18,0,2,0,1
"E00033428",124,57,21,36,0,47,6,41,18,16,0,1,1,2
"E00033432",135,65,36,29,0,50,22,28,14,13,0,0,1,6
"E00033435",125,83,42,41,1,30,5,25,8,7,0,1,0,3
"E00033436",128,53,25,28,0,61,18,43,11,11,0,0,0,3
"E00033437",114,82,38,44,1,23,11,12,7,7,0,0,0,1
"E00033438",127,72,30,42,2,38,13,25,13,12,0,0,1,2
"E00033439",173,82,37,45,0,55,13,42,36,31,0,3,2,0
"E00033440",139,30,15,15,0,99,24,75,9,9,0,0,0,1
"E00033441",141,45,22,23,0,84,22,62,10,10,0,0,0,2
"E00033442",134,91,49,42,0,35,10,25,7,7,0,0,0,1
"E00033443",72,54,27,27,0,14,3,11,4,3,0,1,0,0
"E00033444",115,66,35,31,0,34,13,21,14,14,0,0,0,1
"E00033445",98,47,22,25,1,41,13,28,7,7,0,0,0,2
"E00033446",121,74,36,38,1,36,11,25,8,6,0,1,1,2
"E00033447",94,29,13,16,0,58,19,39,5,5,0,0,0,2
"E00033448",124,60,27,33,1,41,16,25,18,16,0,1,1,4
"E00033449",143,85,34,51,0,32,12,20,23,19,0,3,1,3
"E00033450",121,71,36,35,0,32,19,13,12,12,0,0,0,6
"E00033451",109,42,17,25,0,57,19,38,7,7,0,0,0,3
"E00033452",110,65,34,31,1,32,9,23,10,8,0,1,1,2
"E00033453",78,36,12,24,0,22,1,21,20,19,0,1,0,0
"E00033454",219,150,57,93,0,13,2,11,54,51,0,3,0,2
"E00033455",122,31,12,19,0,77,18,59,12,12,0,0,0,2
"E00033456",133,70,34,36,0,50,15,35,12,10,0,0,2,1
"E00033457",95,19,13,6,0,68,24,44,8,8,0,0,0,0
"E00033458",87,16,8,8,0,61,15,46,10,9,0,0,1,0
"E00033459",143,47,19,28,0,84,14,70,11,9,0,0,2,1
"E00033460",79,30,8,22,0,31,7,24,17,17,0,0,0,1
"E00033462",94,0,0,0,0,88,18,70,5,4,0,0,1,1
"E00033463",103,53,37,16,0,34,8,26,12,10,0,2,0,4
"E00033464",116,60,22,38,0,42,16,26,13,11,0,2,0,1
"E00033466",122,74,35,39,0,39,7,32,8,7,0,1,0,1
"E00033468",119,59,29,30,0,44,9,35,14,12,0,2,0,2
"E00033470",130,76,27,49,0,41,17,24,9,9,0,0,0,4
"E00033471",107,66,30,36,0,34,10,24,5,3,0,1,1,2
"E00033472",105,51,21,30,0,44,9,35,8,8,0,0,0,2
"E00033473",116,65,31,34,0,47,12,35,4,2,0,1,1,0
"E00033474",145,48,29,19,1,33,2,31,62,62,0,0,0,1
"E00033475",157,69,36,33,0,14,1,13,73,73,0,0,0,1
"E00033476",115,47,21,26,0,61,23,38,6,5,0,0,1,1
"E00033477",74,51,19,32,1,11,2,9,9,9,0,0,0,2
"E00033478",115,55,29,26,0,35,7,28,25,24,0,0,1,0
"E00033479",167,99,46,53,0,49,11,38,18,17,0,1,0,1
"E00033480",108,89,51,38,0,5,0,5,13,11,0,2,0,1
"E00033481",172,77,34,43,0,75,18,57,14,13,0,1,0,6
"E00033482",117,78,46,32,0,33,11,22,6,6,0,0,0,0
"E00033483",166,70,31,39,0,63,1,62,30,27,0,1,2,3
"E00033484",121,85,45,40,0,15,0,15,19,19,0,0,0,2
"E00033485",137,96,54,42,0,21,4,17,18,16,0,2,0,2
"E00033486",165,87,34,53,0,26,6,20,49,48,0,1,0,3
"E00033487",157,38,18,20,0,97,15,82,17,13,0,2,2,5
"E00033488",149,32,10,22,0,32,2,30,82,80,0,2,0,3
"E00033489",122,88,47,41,0,26,8,18,7,5,0,1,1,1
"E00033490",108,58,31,27,0,38,11,27,8,8,0,0,0,4
"E00033491",142,47,18,29,0,50,0,50,44,42,0,1,1,1
"E00033492",195,40,19,21,0,77,16,61,72,70,0,2,0,6
"E00033493",142,81,37,44,0,15,1,14,42,38,0,4,0,4
"E00033494",103,65,33,32,0,32,12,20,6,6,0,0,0,0
"E00033495",161,58,19,39,4,49,0,49,48,45,0,3,0,2
"E00033496",152,77,40,37,0,5,0,5,69,66,0,2,1,1
"E00033497",98,57,17,40,11,18,4,14,10,10,0,0,0,2
"E00033498",91,3,3,0,1,80,23,57,5,4,0,0,1,2
"E00033501",98,9,4,5,0,85,28,57,3,3,0,0,0,1
"E00033502",104,71,23,48,0,1,0,1,31,28,0,2,1,1
"E00033503",100,73,28,45,1,0,0,0,25,22,0,3,0,1
"E00033504",129,62,25,37,2,51,10,41,6,5,0,0,1,8
"E00033505",93,69,29,40,0,5,4,1,18,18,0,0,0,1
"E00033506",124,57,28,29,0,54,23,31,8,7,0,1,0,5
"E00033507",136,56,19,37,0,27,1,26,50,47,0,3,0,3
"E00033508",132,31,11,20,0,72,4,68,29,27,0,0,2,0
"E00033509",113,60,28,32,0,32,3,29,21,21,0,0,0,0
"E00033510",137,74,38,36,0,24,1,23,39,37,0,0,2,0
"E00033511",122,36,15,21,1,50,6,44,35,34,0,0,1,0
"E00033512",78,39,16,23,0,35,14,21,4,4,0,0,0,0
"E00033513",130,65,28,37,0,28,1,27,35,34,0,1,0,2
"E00033514",114,53,25,28,3,44,16,28,11,10,0,1,0,3
"E00033515",125,62,22,40,0,22,5,17,40,38,0,2,0,1
"E00033516",110,76,28,48,0,3,1,2,30,29,0,0,1,1
"E00033517",126,57,22,35,0,58,16,42,11,11,0,0,0,0
"E00033518",121,46,17,29,0,38,3,35,35,34,0,1,0,2
"E00033519",139,56,25,31,0,73,28,45,8,8,0,0,0,2
"E00033520",102,65,30,35,0,2,0,2,34,34,0,0,0,1
"E00033521",142,42,15,27,0,37,8,29,60,59,0,1,0,3
"E00033522",151,48,19,29,1,45,0,45,57,53,0,0,4,0
"E00033523",144,103,53,50,0,3,1,2,38,37,0,1,0,0
"E00033524",217,117,43,74,0,34,4,30,66,63,0,3,0,0
"E00033525",131,92,42,50,0,31,8,23,7,6,0,1,0,1
"E00033526",128,79,30,49,0,14,1,13,33,32,0,1,0,2
"E00033527",153,110,48,62,2,32,13,19,8,7,0,1,0,1
"E00033528",126,81,33,48,0,32,4,28,11,8,0,3,0,2
"E00033530",145,135,46,89,0,3,1,2,5,5,0,0,0,2
"E00033531",134,123,56,67,0,6,1,5,4,4,0,0,0,1
"E00033532",166,131,72,59,0,19,5,14,12,11,1,0,0,4
"E00033533",96,87,39,48,0,2,2,0,6,6,0,0,0,1
"E00033534",124,71,35,36,0,24,3,21,26,23,0,3,0,3
"E00033535",133,108,58,50,0,1,0,1,22,21,1,0,0,2
"E00033536",127,93,40,53,2,16,2,14,14,11,0,3,0,2
"E00033537",132,96,42,54,1,23,1,22,8,7,0,1,0,4
"E00033538",147,123,66,57,0,3,1,2,20,17,1,2,0,1
"E00033539",130,108,41,67,0,7,3,4,14,10,2,2,0,1
"E00033540",135,91,39,52,1,4,4,0,36,31,0,5,0,3
"E00033541",129,103,47,56,1,7,0,7,16,15,0,1,0,2
"E00033542",124,83,46,37,0,0,0,0,37,35,0,2,0,4
"E00033543",120,69,38,31,0,28,10,18,20,16,0,4,0,3
"E00033544",104,78,35,43,0,1,0,1,24,24,0,0,0,1
"E00033545",121,81,50,31,0,17,6,11,20,19,0,1,0,3
"E00033546",148,93,47,46,0,40,6,34,14,14,0,0,0,1
"E00033547",126,84,36,48,0,6,0,6,36,33,0,3,0,0
"E00033548",113,69,25,44,0,4,0,4,35,33,0,2,0,5
"E00033549",151,103,62,41,1,35,11,24,9,7,0,2,0,3
"E00033550",124,109,62,47,0,3,0,3,12,12,0,0,0,0
"E00033551",102,93,63,30,0,1,0,1,5,4,0,1,0,3
"E00033552",124,116,57,59,0,2,1,1,6,6,0,0,0,0
"E00033553",161,98,47,51,0,58,2,56,5,3,0,0,2,0
"E00033554",115,105,55,50,0,2,0,2,7,7,0,0,0,1
"E00033555",136,110,66,44,0,1,0,1,23,21,0,2,0,2
"E00033556",114,107,53,54,0,0,0,0,5,4,0,0,1,2
"E00033557",124,119,59,60,0,1,0,1,4,4,0,0,0,0
"E00033558",114,107,48,59,0,1,0,1,4,4,0,0,0,2
"E00033559",110,86,49,37,0,2,0,2,22,22,0,0,0,0
"E00033560",113,101,48,53,0,1,0,1,8,8,0,0,0,3
"E00033561",106,91,43,48,0,7,1,6,6,5,0,1,0,2
"E00033562",117,110,68,42,0,2,0,2,5,5,0,0,0,0
"E00033563",131,126,58,68,0,0,0,0,4,4,0,0,0,1
"E00033564",144,115,54,61,0,9,0,9,17,17,0,0,0,3
"E00033565",117,106,59,47,0,2,0,2,9,7,0,2,0,0
"E00033566",148,87,46,41,1,40,4,36,19,18,0,1,0,1
"E00033567",127,114,40,74,0,1,1,0,8,8,0,0,0,4
"E00033568",144,63,24,39,0,56,10,46,20,20,0,0,0,5
"E00033569",102,89,36,53,0,1,0,1,11,9,0,2,0,1
"E00033570",173,107,40,67,2,37,7,30,25,23,0,2,0,2
"E00033571",121,101,61,40,0,7,1,6,11,10,0,1,0,2
"E00033572",117,91,45,46,0,16,1,15,9,7,1,1,0,1
"E00033573",95,32,3,29,2,58,3,55,3,3,0,0,0,0
"E00033574",118,107,45,62,0,6,2,4,5,4,0,1,0,0
"E00033575",111,104,63,41,0,4,2,2,2,2,0,0,0,1
"E00033576",109,50,19,31,0,46,16,30,11,9,0,1,1,2
"E00033577",120,72,33,39,2,36,4,32,9,8,0,1,0,1
"E00033579",123,13,5,8,0,82,28,54,25,24,0,0,1,3
"E00033580",152,16,5,11,1,120,36,84,12,10,0,0,2,3
"E00033581",221,49,17,32,11,100,3,97,60,56,0,4,0,1
"E00033582",159,45,21,24,0,95,31,64,17,15,0,1,1,2
"E00033583",110,81,33,48,0,1,0,1,27,27,0,0,0,1
"E00033584",107,78,37,41,0,2,0,2,25,22,0,3,0,2
"E00033585",135,97,45,52,0,3,0,3,32,31,0,1,0,3
"E00033586",143,69,32,37,0,35,0,35,37,34,0,3,0,2
"E00033587",153,94,59,35,0,40,5,35,15,15,0,0,0,4
"E00033589",136,60,27,33,2,52,3,49,21,20,0,1,0,1
"E00033590",79,45,26,19,1,2,1,1,30,29,0,1,0,1
"E00033591",94,47,26,21,0,34,0,34,12,12,0,0,0,1
"E00033592",118,11,5,6,0,101,10,91,4,2,0,1,1,2
"E00033593",100,44,18,26,0,29,1,28,25,22,0,2,1,2
"E00033594",143,26,3,23,2,104,44,60,9,9,0,0,0,2
"E00033595",157,27,11,16,1,111,28,83,15,12,0,0,3,3
"E00033596",143,56,22,34,0,41,4,37,40,38,0,0,2,6
"E00033597",105,68,34,34,0,18,2,16,19,19,0,0,0,0
"E00033598",124,42,25,17,0,24,1,23,58,55,0,3,0,0
"E00033599",125,47,33,14,0,37,2,35,40,39,0,0,1,1
"E00033600",139,39,14,25,0,90,18,72,10,9,0,1,0,0
"E00033601",140,48,33,15,0,18,1,17,70,68,0,2,0,4
"E00033602",131,87,38,49,0,1,0,1,42,40,0,2,0,1
"E00033603",136,19,5,14,0,103,11,92,10,10,0,0,0,4
"E00033604",138,56,33,23,0,25,0,25,55,53,0,1,1,2
"E00033605",125,84,43,41,0,11,2,9,29,26,0,3,0,1
"E00033606",114,52,23,29,0,3,0,3,59,58,0,1,0,0
"E00033607",118,50,27,23,0,37,4,33,31,28,0,3,0,0
"E00033608",144,83,41,42,0,36,3,33,23,22,0,1,0,2
"E00033611",122,80,36,44,0,3,0,3,39,36,1,2,0,0
"E00033613",125,63,36,27,3,34,0,34,24,21,0,2,1,1
"E00033614",139,97,40,57,0,5,0,5,37,36,0,1,0,0
"E00033616",141,85,33,52,0,42,2,40,13,13,0,0,0,1
"E00033618",159,125,59,66,0,5,1,4,28,25,0,2,1,1
"E00033620",118,88,37,51,1,18,0,18,10,10,0,0,0,1
"E00033621",103,29,7,22,0,65,27,38,5,3,0,1,1,4
"E00033623",181,21,14,7,5,141,27,114,11,11,0,0,0,3
"E00033624",125,32,19,13,0,76,21,55,14,14,0,0,0,3
"E00033625",123,109,29,80,1,2,0,2,11,10,0,1,0,0
"E00033626",172,155,16,139,1,2,0,2,14,13,0,1,0,0
"E00033627",142,100,14,86,0,7,2,5,34,27,0,7,0,1
"E00033628",139,54,23,31,0,79,28,51,5,4,0,1,0,1
"E00033629",179,124,36,88,0,34,7,27,19,19,0,0,0,2
"E00033630",128,67,30,37,0,30,5,25,31,28,0,2,1,0
"E00033631",129,38,14,24,0,70,5,65,16,15,0,0,1,5
"E00033632",149,14,8,6,1,122,28,94,12,12,0,0,0,0
"E00033633",101,87,47,40,0,2,0,2,10,7,0,3,0,2
"E00033634",158,38,15,23,1,106,25,81,11,8,0,2,1,2
"E00033635",132,102,46,56,0,3,0,3,27,27,0,0,0,0
"E00033636",167,50,19,31,0,96,29,67,18,15,0,3,0,3
"E00033637",196,108,24,84,2,39,13,26,44,40,0,4,0,3
"E00033639",129,52,24,28,0,45,5,40,27,27,0,0,0,5
"E00033640",128,45,12,33,0,64,16,48,16,13,1,2,0,3
"E00033641",127,106,65,41,0,10,2,8,6,4,0,2,0,5
"E00033642",145,137,84,53,0,1,0,1,7,6,0,1,0,0
"E00033643",109,62,24,38,1,23,2,21,23,22,0,1,0,0
"E00033644",95,14,9,5,0,74,26,48,7,7,0,0,0,0
"E00033645",109,51,21,30,0,39,5,34,19,19,0,0,0,0
"E00033646",41,15,7,8,0,21,6,15,4,4,0,0,0,1
"E00033647",99,65,20,45,0,24,7,17,9,8,0,1,0,1
"E00033648",127,46,26,20,1,63,15,48,15,13,0,1,1,2
"E00033649",115,91,6,85,0,3,0,3,21,19,0,2,0,0
"E00033650",134,40,15,25,0,74,19,55,16,15,0,0,1,4
"E00033651",58,22,12,10,0,30,11,19,6,6,0,0,0,0
"E00033652",132,48,20,28,1,71,21,50,10,10,0,0,0,2
"E00033653",105,81,11,70,0,3,2,1,19,17,0,2,0,2
"E00033654",79,24,10,14,0,45,17,28,9,8,0,1,0,1
"E00033655",186,48,24,24,0,102,23,79,33,32,1,0,0,3
"E00033656",83,35,12,23,0,38,12,26,8,7,0,0,1,2
"E00033657",84,29,16,13,0,47,21,26,7,7,0,0,0,1
"E00033658",129,46,17,29,0,58,19,39,25,25,0,0,0,0
"E00033659",157,88,36,52,0,41,13,28,23,22,0,1,0,5
"E00033660",132,59,32,27,0,61,19,42,12,12,0,0,0,0
"E00033662",155,57,24,33,0,70,23,47,26,25,0,0,1,2
"E00033663",122,34,18,16,0,79,22,57,8,5,0,3,0,1
"E00033664",138,37,21,16,0,94,20,74,5,5,0,0,0,2
"E00033665",167,87,22,65,1,48,13,35,31,29,0,1,1,0
"E00033666",130,9,1,8,2,108,11,97,6,5,0,0,1,5
"E00033667",142,69,39,30,1,55,18,37,13,13,0,0,0,4
"E00033668",114,69,29,40,0,18,1,17,27,25,0,2,0,0
"E00033669",125,36,22,14,0,83,20,63,4,4,0,0,0,2
"E00033670",177,68,20,48,0,6,4,2,102,99,0,3,0,1
"E00033672",159,19,10,9,5,99,25,74,32,29,0,3,0,4
"E00033673",124,8,1,7,0,111,21,90,3,2,0,1,0,2
"E00033677",120,27,11,16,0,86,31,55,5,5,0,0,0,2
"E00033678",194,26,11,15,0,82,7,75,84,82,0,1,1,2
"E00033684",212,39,9,30,3,141,8,133,23,19,0,0,4,6
"E00033685",130,15,9,6,1,100,28,72,10,9,0,1,0,4
"E00033686",129,25,9,16,1,93,7,86,4,3,0,0,1,6
"E00033687",162,35,10,25,0,94,5,89,32,30,0,0,2,1
"E00033688",118,18,15,3,0,91,25,66,6,5,0,0,1,3
"E00033689",145,26,17,9,8,101,17,84,5,3,0,1,1,5
"E00033690",169,41,16,25,6,84,15,69,37,34,0,3,0,1
"E00033691",107,41,19,22,0,41,3,38,22,22,0,0,0,3
"E00033692",201,100,41,59,0,0,0,0,100,94,0,6,0,1
"E00033694",114,3,0,3,0,109,8,101,1,1,0,0,0,1
"E00033695",137,49,25,24,0,63,29,34,21,20,0,0,1,4
"E00033696",205,90,43,47,0,82,29,53,28,25,0,1,2,5
"E00033697",145,79,36,43,0,44,14,30,16,14,0,2,0,6
"E00033698",165,94,44,50,0,43,11,32,24,24,0,0,0,4
"E00033699",143,102,47,55,0,3,0,3,35,33,0,2,0,3
"E00033700",97,73,25,48,0,3,0,3,20,17,0,3,0,1
"E00033701",136,118,30,88,0,2,0,2,16,15,0,1,0,0
"E00033702",103,28,13,15,0,60,7,53,13,12,0,0,1,2
"E00033703",167,39,22,17,0,113,15,98,8,6,0,0,2,7
"E00033704",125,114,18,96,0,3,0,3,8,7,0,1,0,0
"E00033705",133,123,23,100,0,2,0,2,8,6,1,1,0,0
"E00033706",116,52,31,21,0,48,18,30,16,13,0,2,1,0
"E00033707",119,75,26,49,0,0,0,0,44,40,0,4,0,0
"E00033708",117,42,25,17,0,66,22,44,8,7,0,0,1,1
"E00033709",76,44,21,23,0,23,5,18,9,9,0,0,0,0
"E00033710",137,77,35,42,0,18,4,14,41,40,0,1,0,1
"E00033711",70,18,12,6,0,43,18,25,7,7,0,0,0,2
"E00033712",124,95,44,51,0,18,6,12,8,7,0,1,0,3
"E00033713",127,91,33,58,0,0,0,0,35,34,0,1,0,1
"E00033715",162,92,23,69,0,15,2,13,54,54,0,0,0,1
"E00033716",121,35,16,19,0,76,12,64,7,5,0,1,1,3
"E00033717",103,59,5,54,0,28,5,23,15,13,0,1,1,1
"E00033718",132,104,13,91,9,10,1,9,9,8,0,1,0,0
"E00033719",127,103,14,89,0,12,1,11,12,12,0,0,0,0
"E00033720",135,118,58,60,1,2,0,2,13,10,1,2,0,1
"E00033721",113,104,18,86,0,2,0,2,5,4,1,0,0,2
"E00033722",94,81,43,38,0,2,1,1,11,10,1,0,0,0
"E00033723",135,121,51,70,0,2,0,2,11,9,1,1,0,1
"E00033724",134,59,26,33,0,57,10,47,16,15,1,0,0,2
"E00033725",145,52,30,22,0,55,12,43,36,6,24,1,5,2
"E00033726",103,73,35,38,1,0,0,0,27,26,0,1,0,2
"E00033727",138,53,23,30,0,64,11,53,20,18,0,2,0,1
"E00033728",141,131,26,105,0,0,0,0,9,7,0,2,0,1
"E00033729",99,75,26,49,0,2,0,2,22,21,0,1,0,0
"E00033730",127,92,38,54,1,15,3,12,19,19,0,0,0,0
"E00033731",87,63,26,37,0,1,0,1,23,18,0,5,0,0
"E00033732",125,80,35,45,0,33,12,21,12,12,0,0,0,0
"E00033733",102,65,23,42,0,10,2,8,26,25,0,0,1,1
"E00033734",111,56,15,41,0,19,1,18,36,32,0,3,1,0
"E00033735",94,4,3,1,0,85,3,82,4,4,0,0,0,1
"E00033736",126,57,25,32,0,23,3,20,46,45,0,1,0,0
"E00033737",145,107,43,64,0,7,0,7,27,26,0,1,0,4
"E00033738",97,25,15,10,0,44,3,41,25,24,0,1,0,3
"E00033739",105,47,16,31,0,47,12,35,10,10,0,0,0,1
"E00033740",140,113,65,48,1,1,0,1,23,23,0,0,0,2
"E00033741",134,80,32,48,0,10,3,7,42,41,0,1,0,2
"E00033742",130,70,27,43,0,2,0,2,58,53,0,5,0,0
"E00033743",108,78,31,47,0,0,0,0,29,28,0,1,0,1
"E00033744",146,81,34,47,0,45,17,28,18,16,0,2,0,2
"E00033745",119,30,9,21,0,73,11,62,12,9,0,1,2,4
"E00033746",124,45,20,25,0,70,16,54,7,7,0,0,0,2
"E00033747",146,52,16,36,0,64,25,39,24,18,0,3,3,6
"E00033748",119,59,35,24,2,47,13,34,7,7,0,0,0,4
"E00033749",118,67,20,47,1,43,13,30,7,6,0,0,1,0
"E00033750",137,118,19,99,3,3,1,2,13,12,1,0,0,0
"E00033752",189,99,31,68,5,14,3,11,69,68,0,1,0,2
"E00033753",108,87,26,61,1,1,0,1,19,17,1,0,1,0
"E00033754",126,92,24,68,0,21,0,21,12,11,0,1,0,1
"E00033755",118,102,26,76,0,1,0,1,14,12,0,2,0,1
"E00033756",133,86,4,82,2,5,0,5,36,32,0,3,1,4
"E00033758",112,56,27,29,0,42,14,28,9,7,0,2,0,5
"E00033759",99,40,21,19,0,48,10,38,10,9,0,1,0,1
"E00033762",122,95,31,64,0,4,0,4,23,22,0,1,0,0
"E00033763",125,102,14,88,1,2,0,2,20,18,0,1,1,0
"E00033764",133,119,24,95,1,2,0,2,11,10,0,1,0,0
"E00033765",131,96,36,60,11,5,0,5,16,15,0,1,0,3
"E00033766",123,106,27,79,2,0,0,0,13,9,0,4,0,2
"E00033767",117,98,15,83,0,6,0,6,13,13,0,0,0,0
"E00033768",116,99,35,64,6,1,0,1,10,10,0,0,0,0
"E00033769",130,29,10,19,6,78,7,71,12,12,0,0,0,5
"E00033770",127,123,19,104,1,0,0,0,3,3,0,0,0,0
"E00033771",132,112,28,84,0,0,0,0,20,17,0,3,0,0
"E00033773",114,95,46,49,0,5,0,5,13,11,0,2,0,1
"E00033774",130,111,36,75,0,2,0,2,17,14,2,0,1,0
"E00033775",185,64,17,47,0,87,30,57,33,33,0,0,0,1
"E00033776",146,46,25,21,0,81,4,77,19,17,0,2,0,0
"E00033777",109,89,31,58,1,2,0,2,17,17,0,0,0,0
"E00033778",128,103,13,90,6,1,1,0,17,16,0,0,1,1
"E00033779",132,24,10,14,0,76,16,60,28,28,0,0,0,4
"E00033780",104,95,41,54,0,1,1,0,7,4,0,1,2,1
"E00033781",170,70,37,33,2,56,9,47,41,40,0,1,0,1
"E00033782",131,105,46,59,0,8,1,7,17,17,0,0,0,1
"E00033783",120,72,16,56,1,40,15,25,4,3,0,1,0,3
"E00033784",189,103,47,56,0,51,12,39,34,31,0,3,0,1
"E00033785",128,92,37,55,0,16,3,13,18,16,0,1,1,2
"E00033786",140,125,23,102,0,1,0,1,14,11,0,3,0,0
"E00033787",130,114,41,73,0,2,1,1,12,11,0,1,0,2
"E00033788",107,91,21,70,0,1,1,0,14,13,0,1,0,1
"E00033789",105,94,22,72,2,0,0,0,8,8,0,0,0,1
"E00033790",109,95,16,79,1,6,0,6,7,6,0,1,0,0
"E00033791",150,34,16,18,0,100,20,80,16,16,0,0,0,0
"E00033792",80,54,8,46,8,2,0,2,16,16,0,0,0,0
"E00033793",134,35,18,17,0,88,19,69,11,11,0,0,0,0
"E00033794",117,30,15,15,2,74,20,54,11,10,0,0,1,0
"E00033795",119,70,19,51,2,31,7,24,15,15,0,0,0,1
"E00033796",89,37,14,23,0,43,11,32,8,7,0,1,0,1
"E00033797",106,40,21,19,0,56,20,36,8,7,0,0,1,2
"E00033798",136,121,55,66,0,3,0,3,9,8,0,1,0,3
"E00033799",117,57,22,35,0,53,21,32,4,3,0,1,0,3
"E00033800",84,70,11,59,0,3,1,2,11,10,1,0,0,0
"E00033801",128,47,21,26,0,70,27,43,5,5,0,0,0,6
"E00033802",76,31,17,14,1,35,19,16,8,8,0,0,0,1
"E00033803",120,44,15,29,0,63,22,41,10,10,0,0,0,3
"E00033804",120,42,19,23,0,57,13,44,16,16,0,0,0,5
"E00033805",97,16,10,6,0,74,20,54,7,7,0,0,0,0
"E00033806",122,11,6,5,6,56,0,56,45,43,1,0,1,4
"E00033807",227,14,4,10,13,159,7,152,40,39,0,0,1,1
"E00033808",92,16,10,6,0,65,31,34,9,9,0,0,0,2
"E00033810",145,11,8,3,0,118,9,109,14,14,0,0,0,2
"E00033811",218,30,18,12,0,153,48,105,32,31,0,0,1,3
"E00033812",177,13,3,10,0,142,29,113,19,18,0,0,1,3
"E00033813",207,33,17,16,0,124,30,94,45,42,0,2,1,5
"E00033814",165,7,2,5,0,148,15,133,7,7,0,0,0,3
"E00033815",168,34,18,16,1,105,13,92,23,20,0,0,3,5
"E00033816",130,47,29,18,2,57,6,51,20,18,0,1,1,4
"E00033818",141,11,3,8,1,118,39,79,8,7,0,0,1,3
"E00033819",142,8,3,5,1,79,4,75,53,52,0,0,1,1
"E00033820",141,9,4,5,0,117,8,109,13,12,0,1,0,2
"E00033821",113,9,7,2,1,59,1,58,41,38,0,2,1,3
"E00033822",159,18,10,8,1,117,16,101,20,18,0,0,2,3
"E00033823",58,24,18,6,0,17,1,16,17,12,0,5,0,0
"E00033824",165,25,16,9,0,112,3,109,20,18,0,2,0,8
"E00033825",135,26,18,8,0,76,5,71,30,27,0,1,2,3
"E00033826",176,39,17,22,2,24,0,24,111,105,0,5,1,0
"E00033827",152,26,17,9,6,54,11,43,66,58,3,4,1,0
"E00033828",155,27,13,14,0,83,4,79,41,35,0,2,4,4
"E00033829",142,8,5,3,6,60,2,58,65,63,0,0,2,3
"E00033832",144,46,31,15,0,29,0,29,68,66,0,1,1,1
"E00033833",192,13,3,10,1,82,5,77,93,89,2,2,0,3
"E00033836",91,7,2,5,0,59,4,55,25,25,0,0,0,0
"E00033837",127,38,21,17,1,71,25,46,10,7,0,1,2,7
"E00033838",105,25,14,11,0,69,9,60,7,7,0,0,0,4
"E00033839",242,76,39,37,18,122,32,90,19,18,0,0,1,7
"E00033840",213,14,6,8,2,119,7,112,78,78,0,0,0,0
"E00033841",145,20,10,10,0,116,7,109,7,6,0,0,1,2
"E00033842",194,17,11,6,1,113,25,88,59,55,0,1,3,4
"E00033843",142,15,7,8,3,105,28,77,13,6,0,2,5,6
"E00033844",134,11,6,5,1,108,36,72,11,11,0,0,0,3
"E00033845",142,10,5,5,1,54,6,48,75,75,0,0,0,2
"E00033846",207,12,3,9,1,116,8,108,74,74,0,0,0,4
"E00033847",127,12,7,5,1,90,11,79,22,18,0,0,4,2
"E00033848",147,137,63,74,1,2,0,2,6,5,1,0,0,1
"E00033849",132,112,58,54,0,0,0,0,19,18,0,1,0,1
"E00033850",162,148,87,61,1,0,0,0,13,11,0,1,1,0
"E00033851",119,90,45,45,0,6,1,5,22,17,0,4,1,1
"E00033852",106,58,31,27,0,3,0,3,44,44,0,0,0,1
"E00033853",125,92,43,49,0,4,0,4,27,26,1,0,0,2
"E00033854",134,121,68,53,0,5,1,4,8,8,0,0,0,0
"E00033855",110,63,47,16,0,28,6,22,15,10,0,5,0,4
"E00033856",180,14,5,9,6,141,15,126,14,12,0,0,2,5
"E00033857",116,98,54,44,0,3,1,2,15,13,0,2,0,0
"E00033859",117,75,45,30,0,0,0,0,42,42,0,0,0,0
"E00033861",171,95,42,53,8,38,6,32,29,26,0,3,0,1
"E00033862",141,102,55,47,0,2,0,2,32,32,0,0,0,5
"E00033863",121,117,46,71,0,1,1,0,3,1,0,2,0,0
"E00033864",110,93,50,43,0,8,1,7,9,6,0,3,0,0
"E00033865",137,128,51,77,0,0,0,0,9,9,0,0,0,0
"E00033866",122,108,56,52,0,11,2,9,3,3,0,0,0,0
"E00033867",118,113,53,60,0,3,0,3,1,1,0,0,0,1
"E00033868",119,115,51,64,0,0,0,0,3,3,0,0,0,1
"E00033869",122,118,74,44,0,0,0,0,4,3,0,1,0,0
"E00033870",172,17,12,5,1,141,51,90,9,8,0,0,1,4
"E00033871",115,102,52,50,0,1,0,1,12,12,0,0,0,0
"E00033872",125,120,60,60,0,1,0,1,3,3,0,0,0,1
"E00033873",138,76,38,38,0,41,6,35,17,14,1,0,2,4
"E00033874",131,123,72,51,0,0,0,0,7,7,0,0,0,1
"E00033875",119,115,56,59,0,3,0,3,1,1,0,0,0,0
"E00033876",117,108,61,47,0,1,1,0,7,7,0,0,0,1
"E00033877",130,124,68,56,0,4,1,3,2,2,0,0,0,0
"E00033878",127,119,65,54,0,1,0,1,7,7,0,0,0,0
"E00033879",116,109,52,57,0,3,0,3,4,4,0,0,0,0
"E00033880",187,132,73,59,0,3,1,2,48,47,0,1,0,4
"E00033881",125,114,57,57,0,2,0,2,9,7,0,2,0,0
"E00033882",104,97,49,48,0,1,0,1,4,4,0,0,0,2
"E00033883",129,113,58,55,0,1,0,1,15,13,0,1,1,0
"E00033884",130,121,73,48,1,0,0,0,6,6,0,0,0,2
"E00033885",213,149,71,78,0,2,1,1,62,58,0,4,0,0
"E00033886",112,105,55,50,1,0,0,0,4,3,0,1,0,2
"E00033887",137,117,53,64,1,1,1,0,17,14,2,1,0,1
"E00033888",130,124,63,61,0,1,0,1,1,1,0,0,0,4
"E00033889",123,117,67,50,0,1,0,1,5,5,0,0,0,0
"E00033890",121,21,7,14,1,60,9,51,35,30,0,2,3,4
"E00033891",131,110,51,59,0,3,1,2,17,17,0,0,0,1
"E00033892",63,22,12,10,0,37,3,34,4,4,0,0,0,0
"E00033893",118,92,58,34,0,1,0,1,22,21,0,1,0,3
"E00033894",126,114,45,69,0,1,0,1,9,8,0,0,1,2
"E00033895",108,56,24,32,0,0,0,0,52,45,0,7,0,0
"E00033896",123,66,37,29,1,7,0,7,48,44,0,3,1,1
"E00033897",123,105,57,48,0,3,1,2,15,12,0,3,0,0
"E00033898",149,72,37,35,1,33,1,32,41,37,0,4,0,2
"E00033899",129,48,37,11,0,28,3,25,51,50,0,0,1,2
"E00033900",112,42,20,22,0,39,4,35,31,30,0,1,0,0
"E00033901",184,32,15,17,0,82,5,77,68,68,0,0,0,2
"E00033902",118,37,19,18,3,42,3,39,35,35,0,0,0,1
"E00033903",112,30,15,15,0,30,0,30,49,48,0,1,0,3
"E00033904",144,46,33,13,0,93,20,73,3,3,0,0,0,2
"E00033905",119,3,3,0,0,113,1,112,2,2,0,0,0,1
"E00033906",126,13,3,10,0,59,1,58,53,51,0,2,0,1
"E00033907",161,38,20,18,0,42,2,40,75,74,0,1,0,6
"E00033908",175,23,11,12,0,65,3,62,82,80,0,2,0,5
"E00033909",114,63,39,24,3,8,0,8,39,36,0,2,1,1
"E00033910",158,66,34,32,1,13,0,13,72,67,0,5,0,6
"E00033911",148,55,30,25,0,35,0,35,58,54,0,4,0,0
"E00033913",111,32,8,24,11,22,1,21,44,42,0,2,0,2
"E00033914",143,49,25,24,1,33,1,32,56,54,0,1,1,4
"E00033915",102,40,18,22,0,22,1,21,38,38,0,0,0,2
"E00033917",136,76,31,45,0,23,1,22,36,33,0,3,0,1
"E00033918",161,47,26,21,0,67,12,55,43,39,1,1,2,4
"E00033919",128,33,18,15,0,88,18,70,5,4,0,0,1,2
"E00033920",150,24,11,13,0,107,8,99,16,15,0,1,0,3
"E00033921",163,20,7,13,1,18,3,15,118,114,0,4,0,6
"E00033922",136,95,42,53,0,8,3,5,33,32,0,1,0,0
"E00033923",138,35,16,19,0,35,4,31,63,62,0,1,0,5
"E00033924",179,37,17,20,1,31,0,31,109,108,0,1,0,1
"E00033925",167,12,5,7,0,81,6,75,66,65,0,0,1,8
"E00033926",138,20,11,9,0,39,4,35,77,76,0,1,0,2
"E00033927",147,70,39,31,0,19,2,17,55,48,0,6,1,3
"E00033928",114,28,10,18,0,70,12,58,12,11,0,0,1,4
"E00033930",126,37,20,17,0,29,0,29,58,55,0,3,0,2
"E00033931",139,44,15,29,2,24,3,21,62,62,0,0,0,7
"E00033932",119,64,36,28,0,14,1,13,40,36,0,3,1,1
"E00033933",97,38,18,20,0,12,0,12,45,42,0,3,0,2
"E00033934",162,20,8,12,0,64,7,57,73,69,0,1,3,5
"E00033935",190,27,12,15,1,68,3,65,85,81,0,4,0,9
"E00033936",127,41,23,18,0,13,1,12,72,71,0,0,1,1
"E00033937",95,24,16,8,0,26,0,26,43,43,0,0,0,2
"E00033938",137,53,30,23,0,25,4,21,58,55,0,3,0,1
"E00033939",113,26,15,11,0,50,4,46,37,35,0,0,2,0
"E00033940",142,36,15,21,4,46,3,43,51,47,0,2,2,5
"E00033941",138,45,27,18,1,48,11,37,41,38,0,0,3,3
"E00033942",180,74,28,46,0,64,7,57,40,39,0,1,0,2
"E00033943",146,76,42,34,0,5,0,5,65,63,0,2,0,0
"E00033944",132,24,9,15,1,39,2,37,66,58,0,1,7,2
"E00033945",96,33,12,21,0,29,4,25,34,30,0,3,1,0
"E00033946",168,56,16,40,1,76,7,69,34,28,0,3,3,1
"E00033947",108,39,15,24,0,40,0,40,28,26,1,1,0,1
"E00033948",151,49,29,20,0,67,4,63,33,33,0,0,0,2
"E00033949",151,33,17,16,1,85,4,81,31,31,0,0,0,1
"E00033950",180,88,45,43,2,61,6,55,27,22,1,3,1,2
"E00033951",121,71,42,29,0,35,16,19,11,10,0,1,0,4
"E00033952",151,136,59,77,0,5,1,4,8,7,0,1,0,2
"E00033953",178,63,34,29,2,70,9,61,41,41,0,0,0,2
"E00033954",112,18,11,7,0,93,27,66,1,1,0,0,0,0
"E00033955",160,52,24,28,1,73,3,70,32,32,0,0,0,2
"E00033956",42,9,6,3,0,30,7,23,0,0,0,0,0,3
"E00033957",134,64,28,36,1,14,2,12,52,51,1,0,0,3
"E00033958",135,34,15,19,0,71,3,68,30,30,0,0,0,0
"E00033959",138,61,30,31,0,29,0,29,48,46,0,2,0,0
"E00033960",129,62,24,38,0,31,0,31,35,33,0,2,0,1
"E00033961",136,51,34,17,0,49,5,44,34,33,0,1,0,2
"E00033962",121,62,26,36,0,17,2,15,41,41,0,0,0,1
"E00033963",173,26,12,14,0,122,15,107,23,20,0,3,0,2
"E00033964",172,18,9,9,0,129,51,78,16,15,0,1,0,9
"E00033965",134,35,22,13,0,57,7,50,41,41,0,0,0,1
"E00033966",133,65,28,37,0,13,0,13,54,50,0,4,0,1
"E00033967",138,44,26,18,0,59,17,42,33,30,0,1,2,2
"E00033968",91,9,5,4,0,66,13,53,16,14,0,2,0,0
"E00033969",113,77,29,48,3,15,1,14,18,16,0,2,0,0
"E00033970",146,46,26,20,0,90,38,52,10,5,0,5,0,0
"E00033971",77,17,10,7,6,49,7,42,5,5,0,0,0,0
"E00033972",135,43,21,22,1,48,12,36,42,39,0,2,1,1
"E00033973",84,27,13,14,1,38,12,26,17,15,0,0,2,1
"E00033974",134,29,14,15,1,84,17,67,18,18,0,0,0,2
"E00033975",174,57,25,32,1,83,26,57,31,29,0,1,1,2
"E00033976",114,69,28,41,0,17,4,13,27,25,0,2,0,1
"E00033977",78,26,16,10,0,37,8,29,14,13,1,0,0,1
"E00033978",116,26,14,12,0,66,26,40,22,19,2,1,0,2
"E00033979",72,7,4,3,0,63,8,55,2,2,0,0,0,0
"E00033980",114,29,11,18,0,74,31,43,8,7,0,0,1,3
"E00033981",90,4,1,3,0,72,17,55,7,6,0,0,1,7
"E00033982",43,15,9,6,0,24,6,18,2,2,0,0,0,2
"E00033983",110,45,11,34,1,12,0,12,48,46,0,2,0,4
"E00033984",102,73,36,37,0,0,0,0,29,28,0,1,0,0
"E00033985",110,41,23,18,0,19,0,19,49,47,0,2,0,1
"E00033986",108,87,39,48,0,6,0,6,14,13,0,0,1,1
"E00033987",133,66,21,45,0,8,0,8,54,50,0,4,0,5
"E00033988",119,55,20,35,0,7,0,7,55,51,0,3,1,2
"E00033989",115,58,24,34,0,14,1,13,42,40,0,1,1,1
"E00033990",120,83,27,56,0,2,1,1,35,34,0,1,0,0
"E00033991",117,78,31,47,0,4,0,4,34,31,0,3,0,1
"E00033992",129,45,24,21,0,76,18,58,6,5,0,0,1,2
"E00033993",208,67,19,48,17,111,15,96,9,8,0,1,0,4
"E00033994",132,89,35,54,0,4,0,4,39,39,0,0,0,0
"E00033995",109,88,41,47,0,3,0,3,18,18,0,0,0,0
"E00033996",117,89,46,43,1,6,2,4,21,19,0,2,0,0
"E00033997",147,65,18,47,1,65,3,62,15,9,2,1,3,1
"E00033998",122,47,23,24,1,62,7,55,11,11,0,0,0,1
"E00033999",118,9,5,4,0,106,13,93,2,2,0,0,0,1
"E00034000",117,42,24,18,0,69,11,58,5,4,0,1,0,1
"E00034001",147,89,19,70,15,34,7,27,5,5,0,0,0,4
"E00034002",107,46,28,18,0,55,7,48,5,4,0,0,1,1
"E00034003",91,2,0,2,0,83,3,80,3,1,0,1,1,3
"E00034004",96,43,24,19,0,47,13,34,5,3,0,1,1,1
"E00034005",131,82,34,48,12,28,5,23,7,5,0,2,0,2
"E00034006",121,74,28,46,5,33,5,28,6,3,0,3,0,3
"E00034007",97,42,23,19,0,44,12,32,11,11,0,0,0,0
"E00034008",120,66,25,41,0,47,5,42,7,6,0,1,0,0
"E00034009",112,47,31,16,1,61,16,45,1,1,0,0,0,2
"E00034010",108,40,18,22,0,65,5,60,2,2,0,0,0,1
"E00034011",141,103,27,76,0,21,2,19,16,13,0,2,1,1
"E00034012",111,32,9,23,0,74,21,53,4,4,0,0,0,1
"E00034013",128,60,29,31,0,58,14,44,10,8,0,2,0,0
"E00034014",111,55,30,25,0,46,8,38,8,8,0,0,0,2
"E00034015",110,43,26,17,0,62,19,43,4,4,0,0,0,1
"E00034016",113,45,21,24,0,64,11,53,4,4,0,0,0,0
"E00034017",123,90,40,50,1,11,1,10,20,18,0,1,1,1
"E00034019",131,80,42,38,0,11,6,5,39,36,0,2,1,1
"E00034020",125,87,37,50,0,1,0,1,37,33,0,4,0,0
"E00034021",120,85,29,56,1,24,8,16,9,9,0,0,0,1
"E00034022",152,108,50,58,0,4,0,4,40,39,0,1,0,0
"E00034023",136,47,22,25,1,48,3,45,36,27,3,5,1,4
"E00034024",145,53,13,40,0,33,8,25,56,48,0,7,1,3
"E00034025",178,38,20,18,0,117,15,102,20,19,0,0,1,3
"E00034026",129,66,35,31,0,29,0,29,33,31,0,2,0,1
"E00034027",108,55,17,38,0,16,1,15,36,33,0,3,0,1
"E00034028",164,41,18,23,0,49,3,46,71,65,1,5,0,3
"E00034029",177,82,30,52,1,57,10,47,37,34,0,3,0,0
"E00034030",123,79,36,43,0,16,4,12,26,25,0,1,0,2
"E00034031",106,66,35,31,0,6,0,6,32,31,0,1,0,2
"E00034032",120,113,61,52,0,2,0,2,5,5,0,0,0,0
"E00034033",98,73,34,39,0,1,0,1,20,19,0,1,0,4
"E00034034",132,82,30,52,0,7,0,7,41,37,0,4,0,2
"E00034035",127,84,40,44,0,7,1,6,33,31,1,1,0,3
"E00034036",120,107,47,60,0,1,1,0,12,11,0,1,0,0
"E00034037",132,108,50,58,1,5,0,5,18,17,0,1,0,0
"E00034038",136,102,40,62,0,6,1,5,25,23,0,2,0,3
"E00034039",143,89,42,47,1,37,1,36,13,13,0,0,0,3
"E00034040",108,80,36,44,0,5,0,5,23,23,0,0,0,0
"E00034041",129,110,60,50,0,3,0,3,15,15,0,0,0,1
"E00034042",135,94,48,46,1,8,1,7,31,27,0,4,0,1
"E00034043",159,67,30,37,0,47,1,46,40,38,0,1,1,5
"E00034044",130,80,40,40,0,9,1,8,39,35,0,3,1,2
"E00034045",152,83,29,54,0,24,5,19,42,41,0,1,0,3
"E00034046",133,51,26,25,0,36,3,33,46,42,0,2,2,0
"E00034047",129,83,26,57,0,10,1,9,29,23,0,5,1,7
"E00034048",117,91,49,42,0,0,0,0,26,25,0,1,0,0
"E00034049",130,93,48,45,1,3,0,3,30,30,0,0,0,3
"E00034050",135,83,32,51,0,3,2,1,49,45,0,4,0,0
"E00034051",106,64,23,41,0,11,1,10,31,28,0,3,0,0
"E00034052",119,76,27,49,0,3,0,3,39,35,0,4,0,1
"E00034053",157,78,32,46,1,26,0,26,47,45,0,2,0,5
"E00034054",133,94,49,45,0,2,0,2,36,34,0,2,0,1
"E00034055",162,63,29,34,0,13,5,8,83,79,1,3,0,3
"E00034056",139,58,29,29,0,24,1,23,55,55,0,0,0,2
"E00034057",112,42,17,25,0,35,3,32,35,35,0,0,0,0
"E00034058",152,25,10,15,0,106,21,85,16,15,0,1,0,5
"E00034059",187,83,40,43,0,50,3,47,54,47,0,5,2,0
"E00034061",142,96,36,60,0,2,0,2,44,42,0,2,0,0
"E00034062",190,44,25,19,1,48,3,45,96,91,0,3,2,1
"E00034063",145,35,14,21,3,12,1,11,92,88,0,3,1,3
"E00034064",119,30,13,17,2,15,2,13,71,69,0,1,1,1
"E00034065",126,100,54,46,0,1,0,1,24,20,0,4,0,1
"E00034066",143,31,18,13,0,62,7,55,48,45,0,3,0,2
"E00034067",131,83,37,46,0,4,1,3,44,43,0,1,0,0
"E00034068",144,47,19,28,4,38,0,38,49,47,0,2,0,6
"E00034069",167,59,36,23,1,30,1,29,74,71,0,3,0,3
"E00034070",157,28,15,13,0,41,4,37,87,86,0,0,1,1
"E00034071",182,73,33,40,0,41,2,39,66,65,0,1,0,2
"E00034072",151,21,7,14,1,84,7,77,44,42,0,1,1,1
"E00034073",101,42,22,20,0,5,1,4,52,47,0,5,0,2
"E00034074",171,59,27,32,1,39,3,36,68,65,0,2,1,4
"E00034075",152,57,29,28,0,47,4,43,44,42,0,1,1,4
"E00034076",143,48,29,19,0,20,4,16,73,72,0,0,1,2
"E00034077",147,40,25,15,0,63,3,60,44,43,0,0,1,0
"E00034078",140,32,14,18,1,68,10,58,36,35,0,0,1,3
"E00034079",162,48,21,27,0,33,1,32,79,78,0,1,0,2
"E00034080",113,44,18,26,0,20,1,19,49,46,0,3,0,0
"E00034081",200,38,9,29,1,74,6,68,87,85,0,0,2,0
"E00034082",117,40,24,16,0,43,2,41,34,34,0,0,0,0
"E00034083",107,39,19,20,0,17,1,16,51,51,0,0,0,0
"E00034084",105,21,8,13,0,19,0,19,65,61,0,3,1,0
"E00034085",143,47,21,26,0,34,0,34,61,57,0,4,0,1
"E00034086",61,17,10,7,0,21,0,21,23,23,0,0,0,0
"E00034087",91,33,19,14,2,4,1,3,52,47,1,2,2,0
"E00034088",161,42,15,27,2,47,5,42,69,69,0,0,0,1
"E00034089",99,47,22,25,0,5,0,5,46,44,0,2,0,1
"E00034090",114,43,20,23,1,9,0,9,60,51,4,5,0,1
"E00034091",73,27,10,17,1,6,1,5,39,37,0,2,0,0
"E00034092",84,35,16,19,2,6,0,6,38,38,0,0,0,3
"E00034093",158,44,27,17,0,45,2,43,68,66,0,1,1,1
"E00034094",141,53,30,23,2,15,2,13,71,66,0,4,1,0
"E00034095",134,49,22,27,0,11,2,9,73,70,0,3,0,1
"E00034096",126,50,33,17,2,7,2,5,66,63,0,3,0,1
"E00034097",109,50,25,25,1,5,0,5,51,50,0,1,0,2
"E00034098",125,68,35,33,0,8,0,8,47,40,0,7,0,2
"E00034099",102,47,24,23,0,11,0,11,43,43,0,0,0,1
"E00034100",150,78,33,45,0,18,1,17,53,47,1,5,0,1
"E00034101",152,88,36,52,0,1,0,1,57,51,0,6,0,6
"E00034102",138,50,22,28,0,32,1,31,53,48,0,2,3,3
"E00034104",153,93,42,51,2,19,3,16,39,37,0,2,0,0
"E00034105",150,27,11,16,1,75,3,72,45,42,0,1,2,2
"E00034106",86,57,22,35,0,11,0,11,15,14,0,1,0,3
"E00034107",128,69,35,34,0,12,1,11,47,42,0,5,0,0
"E00034108",121,23,10,13,5,55,3,52,34,33,0,1,0,4
"E00034109",102,18,10,8,0,49,1,48,34,33,0,1,0,1
"E00034110",143,80,32,48,0,1,0,1,62,59,0,3,0,0
"E00034111",121,36,13,23,0,75,28,47,8,6,0,0,2,2
"E00034113",116,53,22,31,1,47,8,39,13,12,0,0,1,2
"E00034114",123,55,26,29,0,53,18,35,13,13,0,0,0,2
"E00034115",113,63,25,38,0,44,9,35,5,4,0,1,0,1
"E00034116",153,39,19,20,0,99,24,75,13,13,0,0,0,2
"E00034117",124,38,20,18,0,81,19,62,3,3,0,0,0,2
"E00034118",92,41,22,19,0,37,9,28,14,11,0,3,0,0
"E00034119",124,56,22,34,0,59,16,43,7,4,0,1,2,2
"E00034120",103,53,24,29,0,45,10,35,4,3,0,0,1,1
"E00034121",117,47,19,28,0,52,15,37,15,15,0,0,0,3
"E00034122",128,23,16,7,0,96,20,76,7,7,0,0,0,2
"E00034123",137,9,4,5,0,124,40,84,4,4,0,0,0,0
"E00034124",127,15,12,3,0,106,24,82,5,4,0,0,1,1
"E00034125",125,39,18,21,1,69,17,52,12,11,0,0,1,4
"E00034126",148,104,40,64,0,8,1,7,33,33,0,0,0,3
"E00034127",126,56,14,42,0,52,19,33,14,14,0,0,0,4
"E00034130",117,53,31,22,0,52,13,39,11,11,0,0,0,1
"E00034131",152,91,38,53,0,43,15,28,16,14,0,2,0,2
"E00034132",91,32,17,15,0,50,12,38,9,9,0,0,0,0
"E00034133",101,53,23,30,0,31,10,21,16,16,0,0,0,1
"E00034134",133,58,20,38,1,65,21,44,8,5,0,2,1,1
"E00034135",117,82,36,46,0,3,0,3,32,32,0,0,0,0
"E00034136",136,59,22,37,0,60,19,41,15,15,0,0,0,2
"E00034137",108,43,17,26,0,51,14,37,14,11,0,0,3,0
"E00034138",129,16,8,8,0,90,22,68,19,19,0,0,0,4
"E00034139",118,44,22,22,0,72,20,52,2,1,0,1,0,0
"E00034140",98,60,30,30,0,31,12,19,6,6,0,0,0,1
"E00034141",111,18,6,12,0,84,14,70,6,6,0,0,0,3
"E00034142",146,81,40,41,0,57,12,45,6,5,0,0,1,2
"E00034143",123,79,35,44,0,37,6,31,6,4,0,1,1,1
"E00034144",136,64,22,42,0,57,17,40,13,12,0,1,0,2
"E00034145",106,42,25,17,1,36,13,23,25,23,0,1,1,2
"E00034146",120,23,15,8,0,87,20,67,8,7,0,0,1,2
"E00034147",106,28,15,13,0,71,31,40,7,6,0,1,0,0
"E00034148",149,5,2,3,2,134,35,99,3,3,0,0,0,5
"E00034149",118,35,16,19,0,78,24,54,4,4,0,0,0,1
"E00034150",92,49,28,21,0,38,8,30,5,4,0,1,0,0
"E00034151",119,6,5,1,1,107,30,77,2,2,0,0,0,3
"E00034152",127,75,27,48,0,41,9,32,8,8,0,0,0,3
"E00034153",133,9,6,3,0,119,38,81,4,4,0,0,0,1
"E00034154",140,65,32,33,0,64,14,50,9,9,0,0,0,2
"E00034155",148,19,7,12,0,113,11,102,14,9,1,3,1,2
"E00034156",104,4,0,4,0,94,10,84,5,3,0,0,2,1
"E00034157",133,55,26,29,0,64,21,43,12,10,0,2,0,2
"E00034158",140,82,37,45,0,52,19,33,5,5,0,0,0,1
"E00034159",121,81,31,50,1,23,6,17,15,14,0,0,1,1
"E00034160",111,67,29,38,0,36,9,27,8,6,0,2,0,0
"E00034161",131,56,18,38,0,34,1,33,39,39,0,0,0,2
"E00034162",143,69,34,35,0,22,3,19,51,44,0,7,0,1
"E00034163",118,45,26,19,0,59,10,49,14,14,0,0,0,0
"E00034164",158,57,32,25,2,54,8,46,43,40,0,2,1,2
"E00034165",93,13,6,7,1,73,9,64,6,3,0,3,0,0
"E00034167",194,63,40,23,0,102,10,92,26,26,0,0,0,3
"E00034168",127,65,25,40,0,53,14,39,7,7,0,0,0,2
"E00034169",152,39,18,21,0,11,1,10,102,102,0,0,0,0
"E00034170",119,80,27,53,0,29,5,24,7,7,0,0,0,3
"E00034171",113,58,27,31,1,33,5,28,21,21,0,0,0,0
"E00034172",127,75,23,52,0,26,2,24,25,22,0,1,2,1
"E00034173",122,80,17,63,2,7,3,4,31,28,0,3,0,2
"E00034174",111,73,28,45,0,18,1,17,19,19,0,0,0,1
"E00034175",116,34,17,17,0,64,10,54,18,14,1,1,2,0
"E00034176",81,60,18,42,0,5,1,4,16,16,0,0,0,0
"E00034177",134,78,33,45,23,8,0,8,24,22,0,2,0,1
"E00034178",160,84,30,54,1,23,0,23,49,43,0,4,2,3
"E00034180",153,91,40,51,0,19,1,18,42,42,0,0,0,1
"E00034182",72,14,6,8,0,54,10,44,4,3,0,1,0,0
"E00034184",121,46,22,24,0,50,5,45,23,22,0,1,0,2
"E00034185",117,59,31,28,0,49,6,43,9,8,0,0,1,0
"E00034187",137,26,11,15,0,106,14,92,5,5,0,0,0,0
"E00034188",142,88,40,48,0,32,6,26,20,20,0,0,0,2
"E00034189",119,48,18,30,0,61,13,48,8,7,0,1,0,2
"E00034190",103,44,19,25,0,46,11,35,12,9,0,3,0,1
"E00034191",110,52,24,28,0,51,11,40,6,6,0,0,0,1
"E00034192",152,67,41,26,0,55,11,44,29,29,0,0,0,1
"E00034193",125,61,22,39,0,50,8,42,11,9,0,2,0,3
"E00034194",105,41,21,20,0,52,15,37,11,11,0,0,0,1
"E00034195",106,29,12,17,0,66,25,41,9,7,0,2,0,2
"E00034196",141,52,17,35,0,88,21,67,1,1,0,0,0,0
"E00034197",135,60,28,32,0,63,11,52,11,10,0,1,0,1
"E00034199",130,31,19,12,1,85,27,58,9,8,0,0,1,4
"E00034200",128,14,4,10,1,95,15,80,13,13,0,0,0,5
"E00034201",157,57,21,36,0,32,5,27,65,65,0,0,0,3
"E00034202",124,48,26,22,0,64,22,42,9,8,0,0,1,3
"E00034203",173,46,27,19,1,39,3,36,85,80,0,5,0,2
"E00034208",156,11,7,4,1,104,11,93,39,39,0,0,0,1
"E00034209",115,15,11,4,0,78,10,68,19,18,0,0,1,3
"E00034211",126,32,16,16,0,58,5,53,32,32,0,0,0,4
"E00034212",141,7,3,4,0,100,3,97,34,27,0,7,0,0
"E00034213",203,80,34,46,2,98,18,80,21,21,0,0,0,2
"E00034215",50,4,2,2,0,33,5,28,12,9,1,0,2,1
"E00034216",205,23,15,8,0,104,19,85,76,76,0,0,0,2
"E00034219",142,31,12,19,0,64,8,56,45,44,0,0,1,2
"E00034221",128,47,29,18,0,72,24,48,6,6,0,0,0,3
"E00034222",202,28,22,6,0,79,14,65,92,90,0,1,1,3
"E00034223",126,19,14,5,0,72,16,56,29,27,0,2,0,6
"E00034224",137,33,24,9,0,33,5,28,71,70,0,1,0,0
"E00034225",140,40,29,11,0,53,2,51,47,44,0,3,0,0
"E00034227",128,38,25,13,3,30,3,27,57,52,0,2,3,0
"E00034228",149,41,26,15,2,22,0,22,82,80,1,1,0,2
"E00034230",150,40,28,12,0,30,1,29,80,74,2,3,1,0
"E00034231",156,54,39,15,1,15,0,15,85,85,0,0,0,1
"E00034234",147,36,15,21,0,90,28,62,19,17,0,0,2,2
"E00034235",127,54,20,34,0,58,9,49,14,13,0,1,0,1
"E00034236",144,46,20,26,1,89,20,69,6,6,0,0,0,2
"E00034237",133,71,27,44,0,54,12,42,6,6,0,0,0,2
"E00034238",53,24,10,14,0,26,9,17,2,2,0,0,0,1
"E00034239",144,42,17,25,1,85,19,66,16,16,0,0,0,0
"E00034240",134,52,23,29,0,70,26,44,11,10,0,1,0,1
"E00034241",127,43,23,20,0,56,14,42,27,26,0,1,0,1
"E00034242",115,31,15,16,0,73,19,54,8,8,0,0,0,3
"E00034243",172,45,12,33,0,100,32,68,25,25,0,0,0,2
"E00034244",117,58,25,33,0,48,6,42,11,11,0,0,0,0
"E00034245",128,43,24,19,0,77,21,56,6,5,0,1,0,2
"E00034246",121,60,22,38,0,44,17,27,15,13,0,1,1,2
"E00034247",126,48,18,30,0,70,19,51,8,8,0,0,0,0
"E00034248",116,41,20,21,0,63,16,47,11,11,0,0,0,1
"E00034249",147,14,7,7,0,114,21,93,16,16,0,0,0,3
"E00034250",168,42,24,18,0,112,25,87,12,12,0,0,0,2
"E00034251",143,31,13,18,1,61,21,40,49,47,0,0,2,1
"E00034252",183,66,22,44,2,67,25,42,48,48,0,0,0,0
"E00034253",168,33,14,19,0,117,30,87,16,16,0,0,0,2
"E00034254",144,53,31,22,0,71,11,60,18,16,0,2,0,2
"E00034255",136,51,25,26,0,66,16,50,17,15,0,2,0,2
"E00034256",139,60,24,36,2,54,17,37,21,17,0,3,1,2
"E00034257",150,24,6,18,1,109,20,89,9,6,0,1,2,7
"E00034258",133,39,17,22,4,78,23,55,11,11,0,0,0,1
"E00034259",131,28,10,18,0,86,20,66,16,14,0,1,1,1
"E00034260",117,45,21,24,0,57,11,46,13,10,0,2,1,2
"E00034261",108,48,24,24,1,49,9,40,9,8,0,1,0,1
"E00034262",121,70,23,47,0,39,9,30,7,7,0,0,0,5
"E00034263",122,36,17,19,0,76,11,65,8,8,0,0,0,2
"E00034264",140,37,16,21,0,95,23,72,8,4,0,3,1,0
"E00034265",238,188,74,114,0,8,0,8,39,36,0,2,1,3
"E00034266",140,73,34,39,2,4,0,4,59,54,1,4,0,2
"E00034267",99,85,44,41,0,0,0,0,14,13,1,0,0,0
"E00034268",207,88,32,56,0,37,3,34,81,79,0,2,0,1
"E00034269",109,54,19,35,2,18,3,15,35,34,0,1,0,0
"E00034270",145,59,34,25,0,18,0,18,66,63,0,3,0,2
"E00034271",118,78,31,47,0,7,0,7,33,30,1,2,0,0
"E00034272",168,48,18,30,0,55,4,51,62,57,0,3,2,3
"E00034273",95,14,7,7,0,47,4,43,34,33,0,1,0,0
"E00034274",124,26,14,12,2,20,0,20,73,69,0,4,0,3
"E00034275",117,101,46,55,0,0,0,0,15,15,0,0,0,1
"E00034276",127,83,31,52,0,14,0,14,28,25,0,2,1,2
"E00034277",104,89,42,47,0,2,0,2,12,10,1,1,0,1
"E00034278",127,68,25,43,1,11,1,10,45,43,0,2,0,2
"E00034279",189,16,10,6,0,53,20,33,118,114,0,1,3,2
"E00034280",122,3,1,2,0,108,19,89,8,8,0,0,0,3
"E00034281",109,17,2,15,0,30,4,26,62,58,0,1,3,0
"E00034282",180,88,45,43,0,32,8,24,57,57,0,0,0,3
"E00034283",157,92,38,54,1,13,0,13,50,45,0,5,0,1
"E00034284",123,70,32,38,0,2,1,1,46,46,0,0,0,5
"E00034285",141,41,21,20,0,84,5,79,14,11,0,1,2,2
"E00034286",121,37,18,19,0,72,6,66,9,9,0,0,0,3
"E00034287",116,15,12,3,0,87,3,84,9,9,0,0,0,5
"E00034288",128,89,31,58,1,4,0,4,33,29,0,3,1,1
"E00034289",109,51,21,30,0,23,3,20,33,25,0,6,2,2
"E00034290",115,46,19,27,0,32,3,29,35,35,0,0,0,2
"E00034291",100,36,19,17,0,27,1,26,37,36,0,1,0,0
"E00034292",112,62,17,45,0,5,0,5,43,40,0,3,0,2
"E00034293",136,79,28,51,0,23,2,21,33,33,0,0,0,1
"E00034294",234,152,35,117,0,12,1,11,65,64,0,1,0,5
"E00034295",103,40,12,28,0,16,0,16,46,44,0,1,1,1
"E00034296",136,91,38,53,0,0,0,0,45,45,0,0,0,0
"E00034297",129,45,20,25,0,50,3,47,32,30,1,1,0,2
"E00034298",148,87,42,45,0,19,4,15,41,38,0,3,0,1
"E00034299",120,51,21,30,1,29,1,28,39,39,0,0,0,0
"E00034300",105,51,22,29,1,41,17,24,7,6,0,1,0,5
"E00034301",136,36,22,14,1,15,0,15,82,82,0,0,0,2
"E00034302",117,89,29,60,0,1,1,0,27,27,0,0,0,0
"E00034303",138,48,27,21,18,56,16,40,15,15,0,0,0,1
"E00034304",133,43,29,14,0,23,1,22,66,62,0,1,3,1
"E00034305",132,81,45,36,1,12,3,9,36,30,0,6,0,2
"E00034306",140,58,27,31,2,24,3,21,55,50,0,4,1,1
"E00034307",120,30,13,17,0,32,0,32,57,55,0,1,1,1
"E00034308",151,100,43,57,2,2,0,2,47,46,0,1,0,0
"E00034309",120,39,19,20,0,23,0,23,56,55,1,0,0,2
"E00034310",149,47,20,27,0,16,1,15,84,80,3,1,0,2
"E00034311",132,43,20,23,1,13,0,13,73,73,0,0,0,2
"E00034312",144,58,23,35,0,29,0,29,56,55,0,0,1,1
"E00034313",140,54,26,28,0,31,1,30,55,54,0,1,0,0
"E00034314",119,41,17,24,0,47,0,47,28,27,0,1,0,3
"E00034315",168,24,14,10,7,129,8,121,6,5,0,0,1,2
"E00034316",111,36,20,16,1,67,7,60,3,3,0,0,0,4
"E00034317",185,25,12,13,6,141,21,120,7,7,0,0,0,6
"E00034318",106,31,20,11,0,67,8,59,6,6,0,0,0,2
"E00034319",161,60,22,38,1,85,10,75,12,10,0,2,0,3
"E00034320",94,31,15,16,0,57,12,45,5,5,0,0,0,1
"E00034321",47,24,8,16,0,19,5,14,4,4,0,0,0,0
"E00034322",127,62,36,26,0,53,14,39,7,5,0,1,1,5
"E00034323",142,55,29,26,0,70,11,59,12,12,0,0,0,5
"E00034324",128,23,9,14,0,96,10,86,9,9,0,0,0,0
"E00034325",126,78,37,41,1,33,12,21,11,9,0,1,1,3
"E00034326",119,92,46,46,17,6,3,3,4,4,0,0,0,0
"E00034327",108,97,36,61,0,3,0,3,7,7,0,0,0,1
"E00034328",125,118,44,74,0,1,0,1,6,5,0,1,0,0
"E00034329",112,55,29,26,0,55,11,44,1,1,0,0,0,1
"E00034330",103,60,36,24,1,34,6,28,3,3,0,0,0,5
"E00034331",116,44,19,25,0,59,15,44,7,7,0,0,0,6
"E00034332",146,40,15,25,0,92,13,79,8,5,0,2,1,6
"E00034333",138,73,37,36,0,47,8,39,13,10,0,3,0,5
"E00034334",140,15,9,6,0,100,5,95,23,19,0,4,0,2
"E00034335",95,47,18,29,0,41,4,37,7,7,0,0,0,0
"E00034336",106,52,24,28,0,44,7,37,8,6,0,2,0,2
"E00034337",140,124,52,72,1,1,0,1,13,13,0,0,0,1
"E00034338",107,91,38,53,0,2,0,2,14,13,0,1,0,0
"E00034339",120,112,57,55,0,4,0,4,2,2,0,0,0,2
"E00034340",93,79,31,48,0,2,0,2,12,8,0,4,0,0
"E00034341",136,105,49,56,0,18,3,15,7,4,0,3,0,6
"E00034342",94,74,31,43,0,9,4,5,10,10,0,0,0,1
"E00034343",103,81,32,49,0,11,3,8,10,9,0,1,0,1
"E00034344",105,92,32,60,0,2,1,1,10,9,0,1,0,1
"E00034345",83,80,25,55,0,1,0,1,0,0,0,0,0,2
"E00034346",76,25,14,11,13,35,5,30,0,0,0,0,0,3
"E00034347",122,55,28,27,3,50,16,34,8,6,0,1,1,6
"E00034348",111,26,12,14,0,74,10,64,8,8,0,0,0,3
"E00034349",119,16,6,10,4,86,25,61,5,5,0,0,0,8
"E00034350",139,18,11,7,0,110,28,82,10,8,0,1,1,1
"E00034351",179,21,10,11,0,70,26,44,82,81,0,0,1,6
"E00034352",114,19,8,11,0,85,13,72,7,5,0,2,0,3
"E00034353",121,4,0,4,0,114,1,113,3,3,0,0,0,0
"E00034354",150,24,10,14,0,112,45,67,13,10,1,0,2,1
"E00034355",172,34,21,13,0,129,35,94,6,5,0,1,0,3
"E00034356",78,6,4,2,0,63,20,43,9,8,0,0,1,0
"E00034358",173,38,8,30,16,89,9,80,26,23,0,1,2,4
"E00034359",111,49,12,37,16,25,0,25,20,20,0,0,0,1
"E00034360",80,25,13,12,0,40,10,30,15,15,0,0,0,0
"E00034361",101,1,0,1,0,92,2,90,6,5,0,1,0,2
"E00034362",127,8,7,1,0,107,9,98,10,10,0,0,0,2
"E00034363",129,66,31,35,0,44,13,31,18,15,0,2,1,1
"E00034364",124,39,22,17,1,44,9,35,39,36,0,3,0,1
"E00034365",152,32,16,16,0,103,55,48,16,15,0,1,0,1
"E00034366",179,33,10,23,2,124,39,85,16,15,0,0,1,4
"E00034368",136,50,37,13,0,11,0,11,72,68,2,1,1,3
"E00034369",125,55,21,34,2,9,5,4,57,57,0,0,0,2
"E00034371",119,25,10,15,0,91,25,66,3,3,0,0,0,0
"E00034372",117,26,8,18,2,80,33,47,6,6,0,0,0,3
"E00034373",122,8,6,2,0,109,21,88,0,0,0,0,0,5
"E00034374",121,35,14,21,0,79,33,46,4,3,0,0,1,3
"E00034375",159,150,59,91,0,1,0,1,8,7,0,1,0,0
"E00034376",132,99,42,57,0,6,1,5,26,25,0,1,0,1
"E00034377",127,112,45,67,1,0,0,0,14,13,0,0,1,0
"E00034378",130,100,40,60,0,1,0,1,28,28,0,0,0,1
"E00034379",161,108,35,73,2,6,0,6,45,43,0,2,0,0
"E00034380",128,110,50,60,0,0,0,0,14,12,0,2,0,4
"E00034381",222,179,67,112,0,7,0,7,32,27,0,4,1,4
"E00034382",163,72,30,42,0,0,0,0,87,87,0,0,0,4
"E00034383",158,126,38,88,0,3,1,2,26,23,0,3,0,3
"E00034384",127,65,25,40,0,20,12,8,42,40,0,1,1,0
"E00034386",203,64,20,44,1,24,1,23,111,111,0,0,0,3
"E00034387",153,68,27,41,0,36,4,32,48,47,0,1,0,1
"E00034388",137,23,13,10,0,106,10,96,6,6,0,0,0,2
"E00034389",93,81,47,34,0,0,0,0,10,8,0,2,0,2
"E00034390",143,88,39,49,0,1,1,0,53,50,0,3,0,1
"E00034391",153,134,33,101,0,7,0,7,11,6,0,4,1,1
"E00034392",124,106,47,59,0,1,1,0,16,16,0,0,0,1
"E00034393",111,93,47,46,0,6,1,5,10,10,0,0,0,2
"E00034394",127,105,37,68,0,2,0,2,20,20,0,0,0,0
"E00034395",119,52,19,33,0,11,0,11,55,55,0,0,0,1
"E00034396",136,82,40,42,0,9,2,7,41,40,0,1,0,4
"E00034397",134,100,39,61,0,3,0,3,30,28,0,2,0,1
"E00034398",139,88,39,49,0,22,10,12,29,28,0,0,1,0
"E00034399",161,115,52,63,1,20,5,15,23,22,0,1,0,2
"E00034400",138,68,32,36,0,16,5,11,51,49,0,2,0,3
"E00034401",167,81,31,50,0,32,1,31,53,51,0,2,0,1
"E00034402",129,84,44,40,0,1,0,1,43,42,0,1,0,1
"E00034403",145,109,46,63,0,22,8,14,14,13,0,1,0,0
"E00034404",126,94,35,59,0,2,1,1,28,27,0,1,0,2
"E00034405",148,117,50,67,0,3,1,2,26,23,0,3,0,2
"E00034406",151,89,35,54,0,12,1,11,50,44,0,4,2,0
"E00034409",156,111,52,59,0,5,0,5,39,38,0,1,0,1
"E00034410",130,88,35,53,0,26,0,26,16,15,0,0,1,0
"E00034412",176,42,20,22,0,48,0,48,81,77,0,4,0,5
"E00034413",117,88,42,46,0,6,2,4,23,22,0,1,0,0
"E00034414",110,66,23,43,0,10,3,7,34,31,0,3,0,0
"E00034415",176,36,8,28,1,38,4,34,96,92,1,1,2,5
"E00034416",138,106,59,47,0,15,5,10,14,14,0,0,0,3
"E00034417",122,13,3,10,0,101,37,64,7,5,0,1,1,1
"E00034418",158,110,35,75,0,13,2,11,34,30,0,4,0,1
"E00034419",113,65,25,40,1,39,17,22,8,7,0,1,0,0
"E00034420",106,91,42,49,0,0,0,0,14,13,0,1,0,1
"E00034421",132,103,46,57,0,11,0,11,18,16,0,2,0,0
"E00034422",138,49,20,29,0,73,28,45,13,12,0,1,0,3
"E00034424",118,28,7,21,0,81,24,57,3,1,0,0,2,6
"E00034425",147,55,21,34,0,65,22,43,22,21,0,1,0,5
"E00034426",220,34,10,24,0,111,7,104,73,71,0,1,1,2
"E00034427",141,38,22,16,0,86,17,69,16,15,0,0,1,1
"E00034428",148,56,32,24,0,56,3,53,35,33,1,1,0,1
"E00034429",146,50,26,24,0,63,7,56,30,27,0,2,1,3
"E00034430",150,46,19,27,0,53,5,48,50,50,0,0,0,1
"E00034431",108,74,29,45,0,1,0,1,31,28,0,3,0,2
"E00034432",164,110,30,80,0,24,2,22,29,27,0,2,0,1
"E00034433",123,110,58,52,0,0,0,0,13,11,0,2,0,0
"E00034434",145,121,71,50,0,2,0,2,18,18,0,0,0,4
"E00034435",138,121,76,45,0,2,0,2,14,13,0,1,0,1
"E00034436",152,100,57,43,0,19,2,17,31,29,0,2,0,2
"E00034437",172,64,23,41,0,92,27,65,11,11,0,0,0,5
"E00034438",117,104,61,43,0,0,0,0,12,11,0,1,0,1
"E00034439",137,90,37,53,0,0,0,0,39,38,0,1,0,8
"E00034440",135,100,45,55,0,23,6,17,12,12,0,0,0,0
"E00034441",122,114,52,62,1,2,0,2,5,5,0,0,0,0
"E00034442",142,100,47,53,0,10,3,7,31,30,0,1,0,1
"E00034443",132,116,68,48,0,0,0,0,14,12,1,1,0,2
"E00034444",128,116,56,60,0,2,0,2,10,8,0,2,0,0
"E00034445",120,109,59,50,0,0,0,0,11,10,0,1,0,0
"E00034446",186,124,74,50,0,8,0,8,52,50,1,1,0,2
"E00034447",111,107,43,64,0,1,0,1,3,3,0,0,0,0
"E00034448",112,94,40,54,0,0,0,0,14,13,0,1,0,4
"E00034449",93,59,38,21,0,30,0,30,4,3,0,1,0,0
"E00034451",150,71,36,35,3,13,2,11,59,53,0,5,1,4
"E00034453",143,81,49,32,1,11,2,9,48,46,0,2,0,2
"E00034454",218,41,35,6,0,159,0,159,11,11,0,0,0,7
"E00034455",99,90,46,44,0,1,0,1,7,6,0,1,0,1
"E00034456",96,93,42,51,0,2,0,2,1,1,0,0,0,0
"E00034457",100,94,55,39,0,1,0,1,5,5,0,0,0,0
"E00034458",101,95,57,38,1,1,0,1,4,2,0,2,0,0
"E00034459",127,117,75,42,0,1,0,1,7,7,0,0,0,2
"E00034460",109,104,76,28,0,0,0,0,3,1,0,2,0,2
"E00034461",110,78,49,29,0,5,0,5,24,20,0,4,0,3
"E00034462",110,99,57,42,1,1,0,1,7,5,0,2,0,2
"E00034463",89,86,54,32,0,1,0,1,1,1,0,0,0,1
"E00034464",119,113,72,41,0,0,0,0,5,4,0,1,0,1
"E00034465",112,107,64,43,0,1,0,1,2,2,0,0,0,2
"E00034466",132,125,80,45,0,0,0,0,6,3,0,3,0,1
"E00034467",111,107,62,45,0,2,0,2,2,2,0,0,0,0
"E00034468",121,106,66,40,0,1,1,0,14,13,0,1,0,0
"E00034469",98,89,39,50,1,1,0,1,4,2,2,0,0,3
"E00034470",124,118,57,61,0,1,1,0,5,5,0,0,0,0
"E00034471",128,113,71,42,0,1,1,0,10,10,0,0,0,4
"E00034472",162,70,32,38,0,29,4,25,62,57,1,3,1,1
"E00034473",134,118,75,43,10,3,2,1,2,2,0,0,0,1
"E00034474",202,51,38,13,0,56,10,46,92,86,0,6,0,3
"E00034475",130,56,22,34,0,53,3,50,20,20,0,0,0,1
"E00034476",137,77,41,36,1,35,5,30,20,18,1,1,0,4
"E00034477",136,121,61,60,0,2,0,2,12,12,0,0,0,1
"E00034478",202,115,56,59,0,55,0,55,27,25,0,2,0,5
"E00034479",132,121,71,50,0,1,0,1,10,10,0,0,0,0
"E00034480",153,6,3,3,0,135,2,133,12,11,0,0,1,0
"E00034481",137,36,21,15,0,74,13,61,23,23,0,0,0,4
"E00034482",130,23,9,14,0,94,6,88,11,11,0,0,0,2
"E00034483",141,64,30,34,0,60,11,49,11,11,0,0,0,6
"E00034484",149,91,43,48,0,35,9,26,23,21,0,0,2,0
"E00034485",127,97,45,52,0,15,5,10,15,14,0,1,0,0
"E00165671",173,111,40,71,0,30,12,18,27,26,0,1,0,5
"E00165713",52,44,19,25,0,2,1,1,5,4,0,1,0,1
"E00165714",53,41,22,19,0,8,3,5,3,2,0,1,0,1
"E00165715",199,25,10,15,0,82,10,72,91,89,0,2,0,1
"E00165716",161,15,8,7,3,93,10,83,49,49,0,0,0,1
"E00165717",76,59,35,24,0,1,1,0,15,15,0,0,0,1
"E00165718",175,148,78,70,1,4,2,2,22,19,1,2,0,0
"E00165719",133,51,18,33,0,50,15,35,30,27,0,3,0,2
"E00165720",128,88,38,50,1,4,0,4,33,29,0,4,0,2
"E00165721",54,47,25,22,1,2,0,2,4,4,0,0,0,0
"E00165722",167,94,46,48,0,37,0,37,36,35,0,1,0,0
"E00165723",85,72,25,47,0,2,0,2,11,11,0,0,0,0
"E00165724",166,102,46,56,0,14,1,13,49,48,0,1,0,1
"E00165725",75,61,41,20,1,1,0,1,10,9,0,1,0,2
"E00165726",210,81,43,38,0,115,19,96,10,9,0,0,1,4
"E00165727",85,57,28,29,0,3,1,2,23,22,0,1,0,2
"E00165729",143,126,68,58,0,4,2,2,13,13,0,0,0,0
"E00165730",176,162,52,110,1,3,1,2,9,9,0,0,0,1
"E00165731",108,56,26,30,0,16,0,16,36,35,0,1,0,0
"E00165758",66,57,29,28,0,4,1,3,5,5,0,0,0,0
"E00165759",93,62,31,31,0,13,1,12,17,17,0,0,0,1
"E00165760",137,21,14,7,0,102,5,97,9,9,0,0,0,5
"E00165762",163,125,32,93,8,5,0,5,25,23,1,1,0,0
"E00165763",119,28,17,11,1,80,22,58,6,6,0,0,0,4
"E00176596",136,40,13,27,1,63,3,60,32,27,0,4,1,0
"E00176597",136,22,12,10,0,87,5,82,24,24,0,0,0,3
"E00176598",93,72,9,63,0,3,0,3,18,17,0,1,0,0
"E00176599",90,36,13,23,0,42,10,32,10,8,0,2,0,2
"E00176600",112,23,4,19,0,10,4,6,78,76,0,2,0,1
"E00176601",138,113,14,99,0,4,0,4,20,18,0,2,0,1
"E00176602",77,7,4,3,0,28,4,24,40,39,0,1,0,2
"E00176603",113,50,9,41,0,3,1,2,59,56,0,3,0,1
"E00176604",99,21,5,16,0,3,0,3,74,70,0,4,0,1
"E00176605",124,27,5,22,0,2,2,0,92,88,0,3,1,3
"E00176606",118,34,4,30,0,4,0,4,78,73,0,5,0,2
"E00176607",104,13,2,11,0,3,0,3,88,85,0,2,1,0
"E00176608",135,53,13,40,0,2,1,1,80,75,0,5,0,0
"E00176609",144,42,30,12,0,82,7,75,16,14,0,1,1,4
"E00176610",176,30,14,16,0,127,49,78,15,12,0,0,3,4
"E00176611",52,12,6,6,0,3,0,3,37,33,0,2,2,0
"E00176612",108,42,19,23,3,4,0,4,59,57,0,2,0,0
"E00176613",93,24,5,19,2,3,0,3,64,60,0,4,0,0
"E00176614",136,30,13,17,1,12,0,12,92,89,0,3,0,1
"E00176615",222,40,16,24,0,41,4,37,140,45,1,1,93,1
"E00176616",108,10,1,9,0,4,0,4,92,85,0,0,7,2
"E00176617",817,25,17,8,0,187,27,160,603,178,1,1,423,2
"E00176618",89,27,14,13,0,43,12,31,17,16,0,1,0,2
"E00176619",128,23,11,12,21,6,2,4,78,75,0,3,0,0
"E00176620",134,41,23,18,0,15,1,14,78,75,1,2,0,0
"E00176621",88,5,3,2,0,1,0,1,80,80,0,0,0,2
"E00176622",102,31,10,21,1,1,0,1,69,65,0,4,0,0
"E00176623",63,6,3,3,0,1,0,1,54,52,0,2,0,2
"E00176624",109,10,5,5,0,48,8,40,50,49,0,0,1,1
"E00176625",114,22,4,18,0,1,0,1,91,88,1,1,1,0
"E00176626",156,15,0,15,0,3,1,2,137,136,0,1,0,1
"E00176627",112,15,4,11,0,51,3,48,44,43,0,1,0,2
"E00176628",121,4,1,3,1,5,1,4,107,106,0,1,0,4
"E00176629",125,17,11,6,2,19,0,19,85,82,0,1,2,2
"E00176630",130,105,45,60,1,4,1,3,20,19,0,1,0,0
"E00176631",85,53,25,28,0,21,8,13,11,11,0,0,0,0
"E00176632",95,67,21,46,0,7,2,5,20,19,0,1,0,1
"E00176633",80,17,4,13,0,22,5,17,41,39,0,0,2,0
"E00176634",326,20,14,6,0,104,3,101,201,191,1,0,9,1
"E00176635",127,15,8,7,0,2,0,2,109,107,0,0,2,1
"E00176636",123,6,3,3,0,25,1,24,91,90,0,1,0,1
"E00176637",92,3,1,2,7,35,1,34,47,47,0,0,0,0
"E00176638",138,24,12,12,0,3,0,3,109,108,0,1,0,2
"E00176639",82,7,5,2,0,31,0,31,44,37,2,1,4,0
"E00176640",175,34,22,12,0,34,1,33,105,104,0,1,0,2
"E00176641",79,5,3,2,1,49,1,48,23,21,0,0,2,1
"E00176642",180,34,8,26,1,3,0,3,139,136,0,3,0,3
"E00176643",130,33,10,23,0,2,0,2,92,90,1,1,0,3
"E00176644",115,9,4,5,0,26,1,25,78,73,0,0,5,2
"E00176645",116,13,4,9,0,0,0,0,99,98,0,0,1,4
"E00176646",117,8,1,7,1,55,8,47,52,51,0,0,1,1
"E00176647",129,20,5,15,3,12,1,11,93,90,0,2,1,1
"E00176648",190,137,63,74,0,4,1,3,49,49,0,0,0,0
"E00176649",115,5,4,1,13,91,7,84,5,5,0,0,0,1
"E00176650",124,24,5,19,0,3,1,2,95,91,0,4,0,2
"E00176651",108,45,24,21,0,40,6,34,19,17,0,0,2,4
"E00176652",136,14,4,10,2,12,1,11,106,98,0,2,6,2
"E00176653",243,26,8,18,1,6,3,3,208,204,0,3,1,2
"E00176654",125,53,12,41,0,7,0,7,61,57,0,4,0,4
"E00176655",117,15,5,10,0,55,7,48,46,37,0,0,9,1
"E00176656",135,61,25,36,0,2,1,1,69,69,0,0,0,3
"E00176657",138,17,3,14,0,1,1,0,119,117,0,2,0,1
"E00176658",125,9,3,6,1,10,0,10,104,102,0,0,2,1
"E00176659",117,16,3,13,6,35,1,34,59,58,0,1,0,1
"E00176660",110,43,10,33,9,1,0,1,53,52,0,1,0,4
"E00176661",61,2,0,2,0,4,1,3,53,52,0,0,1,2
"E00176662",122,79,18,61,0,5,1,4,38,38,0,0,0,0
"E00176663",138,26,12,14,0,39,3,36,72,68,0,4,0,1
"E00176664",92,49,23,26,1,4,0,4,36,35,0,1,0,2
"E00176665",211,10,6,4,0,176,34,142,21,9,0,3,9,4
"E00176666",90,48,19,29,0,1,0,1,40,33,2,1,4,1
"E00176667",188,89,40,49,0,6,2,4,90,74,7,4,5,3
"E00176668",208,118,41,77,2,54,9,45,33,29,0,4,0,1
"E00176669",111,53,27,26,2,15,3,12,35,32,0,3,0,6
"E00176670",149,62,18,44,0,3,1,2,81,76,0,5,0,3
"E00176671",159,87,43,44,1,46,9,37,23,22,1,0,0,2
"E00176672",92,28,3,25,3,5,0,5,56,55,0,1,0,0
"E00176673",115,28,12,16,0,28,4,24,57,55,0,1,1,2
"E00176674",116,1,0,1,0,1,0,1,111,109,0,2,0,3
"E00176675",248,53,30,23,0,17,0,17,175,170,0,2,3,3
"E00176676",117,6,3,3,1,63,3,60,47,45,0,0,2,0
"E00176677",127,100,42,58,1,4,0,4,22,21,0,1,0,0
"E00176678",126,100,34,66,0,4,1,3,22,20,0,2,0,0
"E00176679",160,5,1,4,0,4,0,4,150,150,0,0,0,1
"E00176680",171,8,4,4,0,1,0,1,162,160,1,0,1,0
"E00176681",119,6,4,2,0,2,0,2,111,111,0,0,0,0
"E00176682",132,12,5,7,0,1,0,1,118,116,0,2,0,1
"E00176683",119,15,4,11,2,2,0,2,100,98,0,2,0,0
"E00176684",134,26,5,21,0,3,0,3,105,102,0,3,0,0
"E00176685",116,19,7,12,1,80,7,73,14,14,0,0,0,2
"E00176686",127,15,8,7,0,7,3,4,105,102,0,0,3,0
"E00176687",135,18,5,13,3,13,0,13,101,97,0,2,2,0
"E00176688",138,11,6,5,2,29,3,26,94,78,0,0,16,2
"E00176689",60,4,2,2,0,16,1,15,40,34,0,0,6,0
"E00176690",100,1,1,0,2,39,7,32,55,39,3,0,13,3
"E00176691",91,6,2,4,0,16,1,15,67,66,1,0,0,2
"E00176692",132,7,6,1,0,6,1,5,116,112,0,4,0,3
"E00176693",84,13,2,11,3,4,0,4,64,61,0,2,1,0
"E00176694",121,14,6,8,0,36,0,36,69,57,1,1,10,2
"E00176695",108,16,3,13,2,39,3,36,49,29,3,0,17,2
"E00176696",177,72,27,45,0,83,27,56,18,17,0,1,0,4
"E00176697",128,68,26,42,0,14,4,10,46,43,0,3,0,0
"E00176698",45,8,3,5,0,5,0,5,32,30,0,0,2,0
"E00176699",126,39,24,15,0,41,6,35,43,41,0,2,0,3
"E00176700",117,5,2,3,1,6,1,5,105,103,0,1,1,0
"E00176701",146,28,4,24,0,2,0,2,114,109,0,4,1,2
"E00176702",77,26,10,16,0,12,0,12,38,34,0,4,0,1
"E00176703",112,101,8,93,0,1,0,1,8,7,0,1,0,2
"E00176704",107,39,14,25,0,20,3,17,47,47,0,0,0,1
"E00176705",79,3,0,3,0,10,2,8,65,62,0,2,1,1
"E00176706",131,103,15,88,0,3,0,3,25,24,0,1,0,0
"E00176707",108,28,1,27,0,61,10,51,17,16,0,1,0,2
"E00176708",89,3,1,2,1,79,3,76,5,5,0,0,0,1
"E00176709",158,6,5,1,0,46,3,43,106,32,4,1,69,0
"E00176710",152,8,3,5,0,111,6,105,28,26,0,0,2,5
"E00176711",121,8,2,6,1,39,0,39,70,65,1,4,0,3
"E00176712",58,2,0,2,0,6,0,6,50,47,1,1,1,0
"E00176713",48,6,5,1,0,27,9,18,11,8,0,1,2,4
"E00176714",88,31,14,17,0,44,10,34,7,7,0,0,0,6
"E00176715",83,14,8,6,0,62,0,62,6,6,0,0,0,1
"E00176716",108,30,13,17,0,5,0,5,73,69,0,4,0,0
"E00176717",92,5,4,1,2,64,3,61,21,18,0,2,1,0
"E00176718",93,7,4,3,0,72,8,64,11,10,0,0,1,3
"E00176719",122,41,12,29,0,1,0,1,80,76,0,4,0,0
"E00176720",122,96,44,52,1,2,0,2,22,22,0,0,0,1
"E00176721",126,78,18,60,0,0,0,0,47,44,0,3,0,1
"E00176722",118,108,16,92,0,0,0,0,10,6,0,4,0,0
"E00176723",110,92,52,40,0,1,0,1,14,13,0,1,0,3
"E00176724",81,5,2,3,0,19,2,17,55,54,0,0,1,2
"E00176725",111,61,28,33,0,4,0,4,46,45,1,0,0,0
"E00176726",130,28,16,12,0,42,2,40,60,57,0,1,2,0
"E00176727",151,49,13,36,2,54,12,42,46,41,1,3,1,0
"E00176728",84,29,13,16,0,20,5,15,35,34,0,0,1,0
"E00176729",108,75,29,46,0,3,0,3,29,28,0,1,0,1
"E00176730",89,33,16,17,0,4,0,4,51,50,0,1,0,1
"E00176731",73,2,0,2,1,34,1,33,34,34,0,0,0,2
"E00176732",145,46,30,16,1,39,1,38,57,54,0,1,2,2
"E00176733",127,10,5,5,0,57,6,51,56,56,0,0,0,4
"E00176734",62,8,4,4,0,6,1,5,48,45,0,3,0,0
"E00176735",127,7,1,6,1,4,0,4,114,106,1,6,1,1
"E00176736",123,17,3,14,0,5,2,3,100,97,0,3,0,1
"E00176737",114,12,4,8,1,6,0,6,95,94,0,1,0,0
"E00176738",62,3,1,2,0,53,9,44,5,3,0,1,1,1
"E00176739",124,8,3,5,0,3,0,3,112,110,0,1,1,1
"E00176740",118,8,7,1,0,44,1,43,66,64,1,0,1,0
"E00176741",116,29,15,14,0,81,16,65,5,4,0,1,0,1
"E00176742",103,36,4,32,0,3,0,3,62,61,0,1,0,2
"E00176743",113,31,4,27,1,36,1,35,45,43,0,2,0,0
"E00176744",54,5,4,1,0,21,6,15,25,25,0,0,0,3
"E00176745",111,47,20,27,0,11,0,11,52,51,1,0,0,1
"E00176746",330,78,18,60,2,126,14,112,115,110,0,5,0,9
"E00176747",52,13,4,9,0,23,2,21,16,16,0,0,0,0
"E00176748",113,11,2,9,2,1,0,1,98,96,0,2,0,1
"E00176749",157,16,7,9,0,2,0,2,138,130,3,3,2,1
"E00176750",119,63,19,44,0,24,7,17,30,28,0,2,0,2
"E00176751",119,76,16,60,8,7,0,7,26,25,0,1,0,2
"E00176752",151,21,10,11,6,84,8,76,37,36,0,1,0,3
"E00176753",95,11,5,6,0,76,25,51,8,7,0,0,1,0
"E00176754",148,42,21,21,0,93,20,73,9,9,0,0,0,4
"E00176755",135,44,21,23,1,78,5,73,11,9,0,2,0,1
"E00176756",136,39,7,32,0,1,0,1,95,86,0,3,6,1
"E00176757",135,38,6,32,0,30,4,26,65,63,0,2,0,2
"E00176758",55,0,0,0,0,44,8,36,11,10,0,0,1,0
"E00176759",104,15,9,6,0,78,20,58,11,10,0,0,1,0
"E00176760",78,27,11,16,0,42,14,28,7,5,0,0,2,2
"E00176761",102,58,6,52,0,23,7,16,18,18,0,0,0,3
"E00176762",94,13,2,11,0,72,25,47,7,5,0,0,2,2
"E00176763",40,3,2,1,0,32,12,20,4,4,0,0,0,1
"E00176764",116,31,15,16,0,68,11,57,14,13,0,1,0,3
"E00176765",108,20,6,14,1,3,0,3,84,80,1,1,2,0
"E00176766",118,18,6,12,0,8,0,8,91,87,0,4,0,1
"E00176767",94,38,16,22,0,49,16,33,6,5,0,0,1,1
"E00176768",179,46,18,28,2,113,19,94,15,13,0,0,2,3
"E00176769",111,4,0,4,50,21,2,19,36,34,0,2,0,0
"E00176770",57,41,15,26,0,3,1,2,12,12,0,0,0,1
"E00176771",44,42,23,19,0,0,0,0,2,1,0,0,1,0
"E00176772",98,91,55,36,0,2,2,0,5,5,0,0,0,0
"E00176773",107,42,6,36,0,2,1,1,61,61,0,0,0,2
"E00176774",53,14,5,9,0,32,4,28,3,3,0,0,0,4
